21,72
27,26
10010001100100010000010000001000110011011101100110001000100110101010111000001000100000010000010011001
10010010100000001100111000010101001100100101001001010011100001001110011100001001000010101100010100100
10000000000000100000110000000000000100100010110110011010001110000000100001110000000010001000000100100
00000010011101010001001000011100000000000001000000000000110000010010010110101010010000101100010001001
00000001011101110000010010010000001010100000001010100010000100000001100000000000100001011101010100000
01010000010111000110000001010100000000000000001011000010000000110100100101000100001000000001110100001
11010000010000011000000011011100010001010100000000010000001001010000001000101000010010110000001001011
10010000000011101000001000101100000100100101000000100110010010111100110110111100100000100001100101101
01011110000010010000100110000000000100010000001001100000000011001101011011011111001000000000010000000
10100100001000000010010010000000010011010001101001101000000001000001000100000100101000011000110000000
10001000110000000000000100001110010000000000010100010000001001010000100100010000110000101001000011001
00010011101000100100000001010011110000011101000001110100000011110000001000010001010100001000110010011
00010001000100000000000010010010011010000100000101000000101110100001100010011000100110001000001000010
00000000111000111001000001011100001100001001000000010010001000000010110010001001101101110100000101010
10100001000001000001100000001000110100000000001011011001010000000000001101011001000111000100010001010
00001100001011001010000010000011000000000000100000100010110000010001100001110011100000000011001000001
00000101110000000000000001000000101011000001100101100001000011000110001010101010100110001100100100000
01101001100010000110101000000000100001010000001001100000110010000001100010000000100000010011011000110
00001000011000110101011001001001100010000010011001000000001000101010111011010101011000010101100001100
10100000000000010000001000000100000010000000101001000000000000101000000100001010100001000000001010101
10000100101000100101001000100000100011000000000100001100000010000010010010011000000010001100001011111
00001000000001000001000000000100100000010000001000111101001110001000100000100101100100100110110011000
00000011000110010100000010000011101000000000101100000100010011011000001110001000111111000010000000111
10000000000010100010000100010000000101100000001000000000111010100101000001010001110000000011001000001
10100000001000010010011000001101111010110001000011010011001000001001000010010000011001010000011000100
00111010000011000001100100100000000010010000000000100000001011100001001000110001000001000110000001100
00000001010000001100101001100101000101001010011000000010100000001011100000101001110101000000000101000
00001101011011100011111000000010010100000100100000000010000010001100000010100110000000101110100000110
00000010000010100110010001010001100000000011010000000001101111111000100000100001000001000110000000001
10001101001001001101101000010100001000110000100011001000000001000110000110000000010000000010100000100
10010011100011100000101100000010100010110000010000000010101100011000000000000010100000000101010000001
00100000000000011000010100110011101101100111000000110100100011001001100000001000100100110100001000001
00010100101000001100010101101010011011101000001100000100100011011001100000000001010011100111100111100
10000000101011000010001000010010101000110111000110010000000000000010000110000100101000010000000010011
00000010000111001001010011000100100001100100000101100011000000000100001100010001000000000000110101010
00100000110001001000010100000000000110000011000000000010000110100101010010111000011010100000000010001
00010000000110110010001110000000100010011001100110101000000000001101100101011010001011000000111000000
01011010101000000000100100010011011011000100001001100001100001100100100101000100000000000110011001010
10100000001010000111000001000000000000001100000000000111101000101000010000110100011100011000001000010
00000011100001100000001111010101011000101010001110001010100001011000110000000111100010101011000100000
01001000001000101110000100101101110110100000100000011000001000101001000000001101110100100001000000100
10110000101010000000000101110001000000001001000000000000101001000000000010000000001011100010000110010
00011000011010010101001000011000011100001100110000001001010000110110010000001010000000001111101011000
00000000110001000100000011100010001110100010010000000101010000110000001010001000110000000000011101011
10010000110000100000011000011010010101000101010000000000110100001101110101110010001010100101011111010
11001000110001011000000001000101001000110000001100000110000010001000100011111010110000110100001101110
01110101011000000001000011100111000100010010011000110001000110001000010101000110000010010100001010110
01000101100000101111100010000111010100100010000110000000000110000010000010100001001010000000010100010
01110010000011101110001100001100000100000110001101001101000000010000000011010000111000011000000110100
10101001010000100001001000101000000011000000010010011101100001110000100000000110010010110100001111000
00101101000011100010000001000000011111001001010100001110101000000000001010010010100000000000000000000
00010000010000000000000000000010001001000011010111000000100100001011000101101101010010000000000101011
10000100000110010010001100001000100110010010110000000100010000100000001000000010000100000000000010100
11010001101100000000000011001000110001010100110000100000000011101001101000010000000000000100100100100
00000010000010000010101011010010010000000000000000011101000111010000010010000000100100000110110011010
00010000101000001000000000100000000000100000000001000100100100100001010101010010011101000110101110010
01101001111100100110001000010101001101011000100000100001110010101100100000000000000010100000000110011
00000110000000001101000000000001000001100100000110000011101010011001000000010001011000010111000000101
01011000000101101000010000000000000000000100010011001001000110100001000000100011000010010010010100010
01000000000000000000000000010000101000000010011000000001000001100001110001011000011000000010100011010
01011001000010100110000100100000111111001100101110000001000100110100110100000000001000010001001001010
10110000001010000001010011100011001000000010110100000111001000100101000001000000110100100000010001100
10100000010000000101010000100110001000101010000011000000101010100101010000001101000100000100010000010
00100010001011000010000011011110110000000001000000000010000000000010010101000001001010101110000111100
00100010000000100010101000010111101000101001100011010100010010000100101001101001010001000010000101010
00010000001000000110110010000000000001010101000001100000111111000100010100110000010101000000000101000
00000010000100011110100010101001000000101000001010000010100010110010000000100011100011000000101100000
00110101100000000000001100100000000010000000001010001100101000100010000000001011101010100011000000010
10001000000111000110000000001101000010101001001000010011001010000001000011000010001000111010000101001
00011000000100000001000000001001100010100011010011000100100101101000010000000011000000000100000000000
10000000011110010000101001110010000010000000101110001011110000010100000011011101010000000000001000000
00000001100010100000100000000110010010100000010001000100000010101111100010000100010000000000000000111
00000010001101110100100010000101010000001000011011100000000110000100100100000111000001000001010001001
11010111000000100000010001110001001000000000000101000000000011001001110000000000110010111000000100000
01000100000100110001000000010000000001000100000010000000100001111000011001000100001001001110000010010
00010001011000101110001001000000001010101001100011100000000000110000000000000100000000100100010000000
01000000000000000010000010011011001010010010010100001000100100001000010011001010011000000000000000001
01000001010001001101000000010010001010101000000110101000010010000000011001000000000011000000000100110
01011100010010001000000000010011110010100000110001001110010100011100001001111011110010100001010011001
00000001010000000100001000000100100101010000100000001100000110001010000010010010000000000100100100100
00000000001001111110100001000101001000000000000000000000110001010000100010000101011011001101010000001
01010000011110010001000010001011010000110010100000101000101000000000100011100010100001101000010011000
00000001100000000000010000011000011010011101010001001110001100000000000101100000111000001010010111000
11100001000111010010110000000000100101010000001000000000001001001001000000010000000000000000100001001
00001010000011100000001010001000000100001000010000100000100010000000000000000011010000000000000111101
00010010100000111010000000000000010000000110000011010001000000110000001111000100000000001001000100010
00100001000001000000000010000000001110010101000101100010101000111001010011000100001000011000001000010
00110011010001010000001010101100101010100011100001010011000000111000101000001111000001010000001110110
01011101000000000100001000101000000000000010000000001011111000001100000010010001000101001001010011010
10100100000000000101100000100101000010110100011000011010110001000101000000100000100010000000000000010
00000000010101100110001100100100010000000100100001001001000010010010000000000000000011010001000000001
00000010100110010110011000100010101010001000000000000000000111100010010100010000000001010010110000000
00000010001000100100001000001001100000100010101011000010010001100000001101000100100101001100001111010
00010010000010001101000100001000000100100110010000100101001110100010110100110001011100001000100001000
10010000000000001000000000000101000000010110000101001100100000000010010100000000110000000010010100110
10011101110001010000100010000000100011111001001000101000110001100100100111000110000100000011000000001
00010110000000101001010000111100001100010100000000000001111100001000010000000000001001100001100001000
10011101001010101001000100100000000100101000111111110001000010001001010000101001100000010100101100011
00010010000010010100110110000010011100010000000110001011001000000110110000000010010000100000001000101
00000100001011100000000100000110000001001000100001110000100011101001110000010010001010101000110000001
00001011001100101000011010000111110000001100011100010011000011001000000000100000000011001010010000000