6,20
99,92
11010100110111100100100000010100100000001000100100110110011000001010000100100100000010100000101000001
10010001010011110000000101000010100101000000010101100000110000000101011001000001000001011100000000000
00010000000001011001000001001001000010000011001010000010001110000001010000001100000000000000000000001
00011001100000000100011000000100010100010011011000011100000011111100000100100001110001001000000000010
10100000010001100010100000001010111001000101000000110110001000000001010000000000100001110001001100010
00100100010000000000011001101000011000101010001000100000000000100000000101000001000000001000000001000
00010001101111100111001000010100010100100100011001001010001010000010010010100001010111000010001000000
00000100100100011101110000000000001101000101100000011010000001000001010100100010010101000100011000000
00001110010010010000100100001100110100111100100101000010110100001101101010100011110010001100000110000
00000000001000000100000100000111010000010100000000100001100010100011000001100001010000100000000100000
00000001011000000001001001001000010111010000100100100100010100010011100100101010000110000000110011001
10000000100111100101100001001010010000101000100010010100001010010001000001100000000000000000001010000
00000000010100100000000101000100100000111000100111000000000000100001010000100101000001001010010101010
10011000010100011110011000010000000001100000101000000010100000100000100100100011000011001100010000000
01000000000000000110000000010110100000011101000000000001010010110100011000001010111000000101110000000
00000010111011011010011011011100110110001000001101010010010000001000001000010000000100100011000100111
11000000110100000000000000011001001000101000100010000001010001010000000011001001000110000010011100000
00010011011101000100000000100000010100101000001110010010000000101000100000100101101001100010110000000
00010000010001100010101001110000000010000000100001100010100010101010010000100001000100000000010000001
11100010001010001100010010010000000001000110110001000011000010101001100010110000100011001000010000000
00111000100100000110010010100100010000011111000010100010000001000101011101001010110010101001000110001
00111110110000000000000100011000110010100110000000000010000010000001010100001000001110000010100001010
10000001100100010100010001000110000101000010010001100000000010011000000000100010000101010000000110000
00000010101000000001011110100010101100001100000100000100010000011000000000000000011010000000100110000
00100000000000001100001000000100000000110001010000000001000000000101100110101100100000111000001000001
01010100100001000100100011010110100001101000010000000011010001001001000001000001011001000100100000100
11101100100111011000101000000110001000010000010011011011100000100011001001010000100101000000110011010
00001000000001010010100000111000100000000100000000011011000011100100100011000000110000000000101000101
10000001110000010000000110000000000001100000000100100000000000000000101101000001110000100000100010010
00010000001000000001010010000010010011000000110100010100001100000100000000000001000100101000000000010
01101000101110001000001101010100100000010000000011101100011000000100000010111000000001110011011000000
10100001100001010000110010100101001001110001000000000010000100000111010000010010100000011000001110001
00001010010100000101000100000010011000000000101000100000000110100000000110110001100010110000000000000
00000100011011000000100000100000001100000001000111001010000110110000100000010000001010011000000000001
00100011010010100000110000110000010010101000100001110000010000010000100100000000010010010010010000101
10000011101000011011011110000000000101100010011001100100111101110000000000010011101100001110100110001
01110000010100001010010110000101000100101000100000000100001000100000110001000001011010000100011000000
00001010000010000011100010001001000111100101010100111100101000000000011100000000001000000000011110100
00000010100000011000100000000010000011010011010010000111011111001010100010000110111101000100000100000
10010000001000100000001100100011010000001111000001100010101001100111000000000010010011000000001001100
01111110101001110111110101000000000000100111000001000000101000000101001010001001110100011110010001011
00010001000011010101000000010000100000001001000100000110010010001100000000000011001000100000010000100
10100100001000000000101011000010100000010000010011100100100101000000010000010010000000001001000010010
00110001001010000000000000011001010101001100000100001100000000000010000010000000011001000001000001110
10010111000000000010001101000001110111100000011001000000000001101111010011000011000110100100001001001
01100000100100001001111011001000000000010100001000001100010000000001011101110001000011000100010101101
00111000100111001000000000101100101000010101000010000101000100001101100100110010010100010000000100000
11101001100001101000101000100000000011101000001000000100000110001101000010101101000000011101000001010
00011000011110000000000000000000110001000000010000001000100100000000101000110000000100010010010111001
00000110110000010010101101111101010000100101000001001001000101001011110010110000001010100000010000100
11000000101100010110111000000100100001010001011000010100000000000000000000111011000000100010100010100
10001000001001100110101000111110010111010001100010000010010011000000101101010000000000000000000000001
11100100010001010110000100010100000001010100110000100000011001010000000110000101000111110110001111000
10100001000011100111100001101001000000100110011101101010101110001011100011001010000000001101100100010
10101101011000010000011100000000010101001010101111001101000000000100010100001001010001000100010000000
00000100110000011101010000010001110000001000101000010010000011000100000100100000000000001001000100000
00000001100100010000100010010010100101000010010000101011011110010000100000001011000100000010000000011
11011000000100000100000000000101010010010000000011001100001000000000111010111000010000100110100001000
00010110100100011000000000110000100010001000001000101000000000110011000101000001010010100000000000101
00000000010010000001001000110001010100010011111100010001100001010100001000010100101000000100001010000
00100000110010000000100000001100000001000001000101000000010100100001000000000011011101110101010000100
00000110000000100001001100000001011101011100100110001010100000101010010111000011000101110100000100001
01000010110000010110000000110100011001000010000010000000000001010100100010000000100000000000001111001
00110001110001000001011100000100010111001101000001101101000000100100010011000010000000000001011000100
01001001011000100110101100000100110000011000010000001000110010000000000010100001100110000100000000011
00000010000000111000001110100111100000011111000000110100100000000100011111000001000010110000000110110
01101000010110010000001000011110100101100000000010000010000000100000000100000101000101011100100010010
11000000100100010011100100100001101000100000100001010001010001000100000000100100111001000110000001000
11000000000100001010110110000000110100100100001101000100010100000001000111001001001000000000101001010
01010011010101110011101000000000000101000110001011001000100110001011010100110000000010010000000000011
00000100010110000001001111000100101000111001000001001010000000011110001001010100100100100100111010100
10010100000000110011010100001110000000001001100001001011000000100001010011100000001011011100001000101
01011101000010001000000010010001000010000010100100000000100000000000001001010011000000010001010000101
00000000001010000000000100100001101010011110100001000100000100100100100100000001100000000000000001000
00010100000100000000001100100000100010001010110000001001000110000110000011010001000000001111000110000
10010001000010001001000010000001000110001010000100000001000100000000111000101010000000000101100010010
11010000000110010001101000111011001000011001000001000001111001000010000000000010000100000001000001001
00000100000010000000000100000000101010001000000110000000000000000100001010000000011001010000001010011
10000011000011000000000101010010110110100000000100110010101011100000111011101000100011011010101000001
00101110000001100000000001000001000000000010001100000100011001100000011000011000110110010101110010001
01000000000011000100110011100001010000000101011001000000011100100000010001101000001110100100000111100
00100110001110000000100101101100000000000000100000111000000000111000100000101010000010110000001000010
00000010100000010000000100100110000001000000111001000010100111000000000100111000011001001010000000110
10010001100001000001110111110001011110000000111111101000100000101001101001001100101001001001000000001
00101011000001000110000111010010011011000110000100001000000000011001011101000010000010000100110000000
01001110000101100001011000000010100001100001000000010101000001010011000110000110000001000001010111000
00001100000100010001110000001100010000101000000010000000010100010000010101000000001010000000101100011
01010000000010000010101100100100110001000000000000000100110000001011000000011001101000000000010100000
00011110000010001000000000000000000010010001100000011010000001000101010000010010110000011110000001100
00001001000000000100010001101000100110010000010011001100000000110011001010100000010110000000000111100
00100010000100001111000111010000100000010000101001100011000000100000000101011011001001000001000110100
01100010100110000001000001110000100001000011100000100000101100100000000000000000100000110101000010010
10011000000100001001100000001100010010000100000100001100001100001100000001011000000100000010100110011
10010000100000011100010000000100101001000100000001100001011000110001011100110001110111100000000101110
00110001001010000001001001100000000011100001001001100000100000010010101111110000001110000100010000101
10001011010000111000100100100110110000000000000100000010001000010000101100000010100101100000000100101
10100000010100000000000000100000101000000001010001011001000100001001100000010110010001010001001000111
10001001100101010000001101001010001000101001110101000000010000000000000000010101100000011001010101100
00000011000010011000110000011001100000001100101010000000011000000000001100001010010000000000101100011
00000000100100010100010000000100011000000000010000000110011000000100000000000001010100000000010110100
10010100010001010100100000000010001100010001000011000000010111000010100000000000000100010110100100010