24,87
36,65
00001101100101001100010001111001000000000100101100001001000001001100100001000100000001000010110001011
10110101110000000001010100110000100010100000010010000100001011000000100110000100000100110010100010001
10000000000010000100000011000001110110100110110000000010001100000010000110000000000111000000010000000
10000100101001000001001110001101010000011100100000000100000101000010000101110000001011000000001010000
10100101101001000000000110001010110001101111000000111000000001000010000100000001000111000100000010000
10001100100000010111001101010010101000111010001110000000000000000010001111100000100001011000000000100
01000101111011011010010110100000001001000101100000000001000000011101001100010000000100000000010000000
00001100010000000000001110000000000000001100100000000010000000010100011001000110000100100000010001101
10000000100100101000100011000000100010011010011010000110101000000010010001100000000010100000000000000
01100000000000110100000001101100000001000001010000011100000001110010101001000000001101111000110010011
10000010011001010001110010100001000000000000000100010101100000100000000110001000000101110100000001100
00010000000010000011001000001100001100001000001010101000000100010100000100010000101000100001110001011
11000100010000010001010000100000000110000001011010001000000001000110000000100010010000110001001010001
11010000100000001101011110001101000000011101100000001000100000001011110110100101101000000000110000001
00101001010011010010000100010000010001001010010011101111100011011010001010011010000000010100010000110
00010110001000000001001100000010000000101011001100011111101010010101110000100001000000100100000000100
00010100000000000101100000000000000001001100001011000111000010110100011001001011001010010000000110011
10010000110001000100011010010110111101001000100110000000000101000011000110010000000110110000011011110
01101000011001001000000010110101010000101101100110000100011000000010100000000000000001000101011100000
00000011010000001000110000001001000000001101111001100000100100010011000000001010000000000100000000001
00010010001111000001101100000100000110111100100000100000001000000000110011000100000011110000011010101
10011001101110101001100100011111000001111010000011110000000010010011000100000100001110100010001010000
11000000000000000000001000010010000010011011101010111000000000001000110010001001111100011000010111000
00100000000000110000101100010100000111100011001100110001110111100010110001000000000000001001101001001
11000001000000100010001100001101000010001010011110011101000000000000000110100001010110101011001010000
00000000110111000100001100100010010000001010100100000010110000101001101000011101100101110111111101001
10111010000010000010000100010111000001001100000000000001010000000000000000000000100100001000001000001
10000010001110001100000001100000100010000010001110000111101100000100101001000010100100010000000110000
00010100100000011101011100100010100010100100000000100000000000000000011011001000011100011110010110010
10001100001100001000001000000001100100000100010001000001000000000100010000010101000000100011000111000
10011000110000000100100000110000000010010010100101001000010001110100001010010010000010001000001100001
01010111001000001010100000000100011011001100100000000010000010000100000100000100010011100000001010010
11000101001100100000010010000100001100010010001001000110010000011010010100000000000001100101010001001
00100000010100011000011000110101011100000001100011110100101010011001001101001110010011001101010110001
00010010001010100000000000000000001000000010010010000110010001000110000110000001100000000001100010001
10010101100110100100000100011000010001101100100000100001100000100000010011001110111100000010001011100
00100011001001000100000011100010000001001110010100001000100111010100000000001010000001110000010100000
10001101101000000011000000000001110101001010010000101110000100001000001000000110001001000000000000001
10010100001011000001010101011100000010011000001100011101111000100010010000000000100001110010010001000
10101100000111100101010000000110101000001000011000100000110110101100101111001100000001111011010000110
00110110000110110100010011010001110000001000000110100000010001011010000000011110001000011000100000100
11011000101001111000000001111000001000100100001111100000010000000000000001110010101000110000000111010
00001000001111101000001111010010000000000010000010010000100010110111001000001010101000000000001110100
11000010000010100100000100111000001100100111110000010000010001100000000010000100000000011001100010000
01101100100000000010001000010000000001000010000110000011000010011101010001011000001000110101000110000
00100000110100000010000000001001010000000011010010000110011111000100001000100001000000000100000001000
00110000110001000000100101000001010100001110001001000001010010100100010001001101100001010111010111001
00001001010000001000100010110100100001000000000100100000000000010000101011101100011000110011000001000
01001001110000010110100001100010001000000010101010100001000101000100100001110101001000000000010000001
10000010001011001000000101001010000110010010011000000010111001000110100000010010010101111001100000000
10011010010000000000000011010000010001000010000011110100010111010010100100010000000100100011000101110
00000100110000110011000001100000001000010000010000110000000100000001111100101001010001001001010010001
10100000010100101100011000011000000100000110100001100011000100110001000000110110111000000001101010110
11111100110100010000000110100110100001010000101110010000001001101110010101000101110001100110000100010
01011010000110001000110110101000110100101101100011110000000000000000010000101001000010000000000110110
00000010000001000011100110100000100010011001000000011100000100000001000000011101000000010101010010010
00100001101101111100010000001001011010000111000110001100111000010101001100001001111001000000000000100
10010011010000000000001000000001000011000001111101010010010010111010001010000100110011000000000100011
11011001000010100010000000000000010001000000000000000000000111010010100000000010010011001110010000000
00010010010000000010001000100100010100101001000101011000100011010010010011101000110100001010001000100
10101000100100100000010101000000011000010000101010101110000011011100000100100000000000100010000000000
00100100011010001001000100001000000010010000000100010001000110100010100100100000000100000010000010100
11000000000010010100100001110000000101111010101001000100110000111000000001000100100000011100010100000
01001000010001101100000000010110010000001111000100000000001100000000001100011100000010000011000001001
10000010011101000000100000000000010000000101100000000110000000101100001100000010010001100010000100000
10001000001011000011000000000101000000000100000001101100000110100000000000001010000100010000001000110
10010001100010000001010001001101000000000100101100000010000011000001100001000100101100010001001000001
00000000001000100011001101000000000010010010110000011010010000110000001010000110000000100000100100000
10001110111000100100100011100000010001100000000000001011011111100101000001000000101100000000000000001
01010000001110111100001111000000000000000100100010000001000000000100100111001110100101000111000111100
00001000010001100101100101000000001101100100010010001111010110000101111000000010100101010011001000010
00010100011001000001001010000011000010001001001000111010110010010000110000010000100011000001000010110
00101000100000101001100000011001100010000000000000000000001000010100110010000100000000001001000000010
01100000010000100011000111011011100011000000000011110110000001000110100000000100001000001001000100010
01001010011100100000010011100110101110001011000100000001000100100010010101110011000110000000001011000
01110000000010000110100000000010000100101101001000010000010100101000000101001101100000111010110101100
00011001001101010101010010000001001001100000100111000001010010000010000000111000010111000010010001100
00001000001000001100100010001001000011010001110001000101101100001010101010000000010001011010100100001
01100011101001100010010011010000101000110000000100000000000111001100000010010000111100001010100000100
00001000110000001000110100110100001000011000011000010000101000010001000100000100011000011101011101001
00000100010011000010001000000010000010100110001111000000100000000000000010000001001001110000010001100
01001000011011000100000110000000000000000000010010000100000100100100011010000010010010000100100000000
00010100010000000100100000000111010100001110110010000000000101110001111101001011000000010000000000100
00101001000010000011000000000011100000011010010101010110000001000000000001100100010010000100000000011
00010100000100000101001001000010001011011010000000001001000010001010001010101000000000000100111110011
10010001000110100110000011000100101000110000001000000000011001011001000001110100000011111001000001000
10110000011010110000000101000001101000000001100000001100000000000000000000001100000000110010000000010
11000101010001000000000000001010011000000000011100010111001000001000000011000000010001010100101100000
10011010100100100010010001001011111100000001000100100110101010111100010011100000011101001010110110010
00010000011000000010000100101110000001000000000110101000001010001000101100100100000000000000000111000
01011000010101000000110000001001000101000010000011010000100101001000010001000000000000000000000010011
01000001000100001010000000000000000010100101011000000100011000000001000010100000000000100000101000100
10000010000000100001001000010001001110010100000000100010000001000001001011010110001001000100001001100
00011000000010000000101000000010100111011011100100010100011000010000001101110100000011001010100001000
00001001000000100011010000101010000001001100100100010001000110011000000001010001000000100000111011001
10000000000100100000000000001101001010001000000001010100000001000100010101101000011000010100000001010
11010000101110110000000001010010000000100010011100100010000000101010000001010011001101011100101010000
00000001011000110000010100000100100000010000010011001100111101110010010000000000000010011010011000000
11001001010100000001100001010000000000100000111010001010110101000100001001000110011000100000000000010
00000110001001100000000000000100010110010001100100100011000001000001000000001000011010001000000001100
00100010100011010000001000100000100100000000000110100110000001000011111010110001101000000010000110000