21,25
100,22
01000000001001000010000111110001010000000000100110000111010001100001010110111000000000010000010100000
01000001011100010001000010100001010000001000000100000000000000011000100110100010100100010001001100010
01000000000100000110000101001100000000000001000101000000000010000010011011001010100000100000011001100
00011000011010000010001000001000000011000000100010000000000100000000100110001110010100011010001000000
00000010110000100000111100100010001010010000000011110001001010010110000100011111000010000000100101001
10100011111010000000001001000010101001000101010010001000000101000001100000000011010010010000000110000
10001001100000000000100000010000100101101000000000000010001011000000100000100000000110000101001010000
10000000111000000010010011000000010010000000000001011011010000100101011100101100100000010010010011000
11001000010000000110000100000101100000010110000100010000100001010111001001000101100001000000000000000
00000001011100000101000010101100000000101000111000001000010000001101111000100101000001010000100000000
00101010010010000000001100000011100000000010010001000010100000001000011010000001000100001000000010110
10000010101010010000000000010101100111011000100011000010110011011010100100000010000001000010000111011
00010000000100001000000010010001110001011000000100110110100000000000110000100000001001000000110000000
11001000101000000010111101000100000000010010100011100000010100100110110010001010001111011001000010101
00001000001101001000100001010000000000101000001000000110100011000110010010000000111010010100001000010
00001000100010000000100010000011000100101100000100110000000000111010010010101010101000000010010000110
00010001000010101000011001111000110100000100010100000110000001010010000000100000100001111000000011011
00010000010000010111001000000000101010001000010110100000110100000001100000000101001101001001101000000
00000100000101000110000010000000010001001101011110100110100100010100000000000000010010100000011000000
01001000001100100100010000101000000100100100110110001001001000101110100101010011000000000101101111010
10000000110101000000010001100000100101000000000000111101000000011100110000001000000100101001101000010
00000010000000001000000000000110100010000000010010101100100101000100000100010100001111010011000100010
00010011000101000001000001101000010000010010000000110000100100010000001000000000001001001000001110010
00110000001000011010100000011101000100100000001100011001101010001010000100001010001101001100001000000
10100000000000011010010000011000010000000101000010100000001101000010000000100100001000001110100110111
00110000111100100001011001000010000001000000000011011101010000001000110110000000000001010001101100100
10110010000000000000110000000000100011000100000011010000000110110000000001011000000001011000100001100
10000001100001010100110100010001000000000100100101000100000010001101011000100010010100101000000100111
01001000001110000000010000010100010000000000001001000000011101100000010111010000011000111000000010000
00110000001000001110010001001101100110110101001011000000010010100010100000111101110000001001000000101
10000000000000100100100100000100100101000000000001010001000100001100001000000100000100110000100000010
00111000000000100000011101001000100101010100100001000100110000101000000000001010110100110001000111110
01000000011001000000000001000000001000100010000011000110110010011011100001000000000000011111000000011
10000101001000001100001110000100000111011010000000001100010001000001100000010011100000101000001000000
11001010000000001000000001001010010000000100000000000011000010100010010100000100011010000000110110100
00000100000010100100000001001000010000101110001000000010100010000000001000011100000000000110000000101
00000000000100011011100000100110001000001000010000010010001001000000100000000000100010001000011001101
00010000000001000000110110010010101000000100001000010010001011001110010100000000000000000011000000100
00100000100100011001110100110000101001111100000000001010010101000001100000000101010110001010001000100
00100001001100000000000100010110101001101000000100101000010010010000000000100000010100001100110010001
01101110100000011000000000001110001000001001000000100001001111010011110000100010000000000000001010010
00000100001000010001001111010000110010000010100000000011010010011000000010010000001000010000000110101
00001001000000000010000100000001100001001100010000001001100101000110111000111000001000111100000000011
00010111000101000000100001101110000010010001001000100010101101011010010111000110000100000000001000001
10000100000100010011010000000001100000100111011000100011100010100000000010000100110011111110101000000
10111000011000100100000000100001001001001000011101001110010001110001101100101011000001110101010101011
00010001000101001000000010000010000001000001110010010000110000000001011100110100001010011000110011110
10000010001000010100001011011010001000001100000010010000010000000000000000010100100000101000000001010
01101110100000000010000110000000110001011010101100011100100100000100100101100110000001000100010101000
01001010010000000100010001000100100001100001000001000110000011000000100000110011000101110101100001101
00000000000000010000011101100010000000001101000100011000010000101000000000100001010011100000001010011
00011011001100110000000001001000010100000010000000010101100100000011000000100000100100100000110010110
00101000001010100001000000001001010010000011110001100000000001000101001010000001100000010000000100011
00001010111001100101101111111110100101000000001110100001000010001110110100000111000100110010010001010
00100001110100011000011000100000010001000001100001000000100001000001001011101010001010100111010011101
01000001000000011010001000100010000010000010000001010011000000001000001100000000100001000000100000001
00000001000100010001000010001010000011010011010010010110011000000000100000110011100000100100000101110
00010010100001001000000001011000000110110001000000010001001010001010100000000001000000100000100000100
00010100001001000011010000100000000110001000010000010001001010100010101100000000011000000111110110001
00010000000100110000011001100000010100001000000001001000000011001110000000000000100011101100011001101
01011000101000011110001000000000001100000011010001001001011001101011100101101100100000000000000000011
11110000000100010000010001010001000000000010010000011001000010111111000100010010001100101110100111101
00000000000000000000011000000111100010001110100000000100100101000101010000100000100100100010010001100
00101000000011001000100001010100000000000000001000100000101010110011000100000100010000000000000000001
00000001001111000010000010000110000111000001000000101100000000100001100001000100000101000000000110001
00010100000010010010000000101101100111100001010000000001100100011001000001010101010000010000000001011
10010101011000010000100000000110000011001001101111100001100100000101010000000001100000000001011010100
01010110010000100100000000000100100010010000111000000000001000000011000010001000000011001100000000101
00000110110100000010000000001001000100000100010000100000100000000000100111000000010010000101010100100
00000001001101110000110000001000000000010010010110000010000011011010000110010111000100000000010000001
00101110000001000000001001100110000000010000001011100011000000001000001001000000001010001001010110110
01000001000000001010010000100000101000010001101001010001001001010100000010000100100110001000010001001
00010000000100010001100010000000000100001001001001010010100000011001110010010011010000000001011010101
00100100100000100100011010001000000101000001000000001100000001000111010101000000100100001001100001000
11010100011001000011000110010000101010100111110110100011000110110100000010000001010010011100100000101
00010101000101000000001011100010010000000010010101101100000000000010001001001100001110000011010010000
00101000100000000000000000101110001000011010000001001000100100100000100000001100001010010001000011100
00000100001010100001000101000010100000010100100001000000010000001001100011100010010001000111000101100
10010000100101000001100000010000010001000001000001000001001100001010100000000010000010000000001101000
10011100101100111010010100100110000001001000011001000110010010010001100000001001101001000000001001000
11010000010100000001010111000000110001001011100001010011010000101001000011000010000000100100000100010
10010100011010010010000101100101011101110011000000011001000000000001001011011101100101000000000010000
00000100001010001111001000000000000101000000111100001001110100100100010100110110010100011010000000001
11101000001110010100101001100110011001101000000101000011001001100000000100010111110101011000011000110
10101101101101111010001000111101010100100010001110011110100000001011000011010011011101000011000100000
00010010100100000001110100001000101100110000001000101000000000100010101011010100001010000000000110000
00001010100000010000000000001000001001011010001101001101000111101100101101000000000101000000000000100
01110101000000001001001000010010001000100010100010000000000100000010001001100000000001000011000101000
00000001110000110000100010001000010011011000000100010010010000101110011100001001000011001110010010110
00000011000000110001010000110111100110000111001011000000101000100000000010000010000000101100001100010
01000100001001110010001101000111010111000010001001000010100001000000000000000000000011010010010000011
01000010000000001001100111100100000100000001100100111001101100100110001010000001000010000011100000000
10000010001011010001001110101000000110010001010100010000110110000110000000000001000010111000010100001
00001110000000000010010000101000001000001000010000010000100000100110001100000110000100000010000010000
00011111000010110010011100110011001011100000011000010000000000010010101010100011011001010000011111100
10011010100001010000000000000000100100000001001000010010001001110000000001110100000100100100001000010
00100000110000100011011000000010101000001000000101000010000110110000001100100110000010000000100000000
01100100000010000000010001110000000100011001000000100100001010011000010000000000011100000011100111100
00000100000100100111000100000000011000010000011000000000000110010110010101100110100010101011000110011
00011000110100000000010101001010000000100000000010000000001000000010001001000100001000010100001000000
01000010011110000101001001000000110011100001001011110000010010000011110101000100000110000001011001001