75,78
61,46
10110110100000111010000000100001000000011100111100100100101100000000100001000000000000010000100000000
01101001001010000000000000000000000001011100001100000100101100000001000010111000110000000000010100000
00011001001111000100011101100110011010010001111000000110011100001001000101101001100110000110100000000
10101010001000001111010010101011100000000000000000000001001001000000010000101010000011111000100110100
01111000010000011110011001001010011000000010101100001100000001111111100000101010100000000010000101001
01001110001111000111100000000111000001000001000100000001011101001001100010101110001101011111100100100
00000000001101000011000100010000011010110100100011000101001000000100010010001001011000010001110000000
10001000010001010010000000100000011000011010100010000101011010000010111110111100001001000101010000010
01011101011010000101100000001011001001100010001010110000100000100000000001100001000110000001001010001
01000110011010110110100100011000000000000101010000010000110001000000000110010011010010000010100100001
10001000000000110000011101010110011001000010011100000100000001110010001011010100001000000100100100000
00010000000110000000001010010101011010000010001001000110001000100101001000000101000001101011000000000
00000000000000000011000001101110100001100011000000001100101100010000010100010100000010100010101001001
01000110000000001101110001011000000100010010001101001101000001000101001011011010001000100101011000000
00101100110010010111000000101100100100000000100000010100100100000010010101110101000000000000100011000
00000000000000011010100100100010000101001000000110001011001001001000000001000100000011100000000000000
01100010111000010011001100010011011000001100110010000000000100010000001101001000010010010101000000000
00000000100000000000001010000010010000000000001101000001000010010010000000000010000100100111110100100
00001101000000000010001001010001000001000010000100001100000000100000001000000011000100100011000000001
00100101000001100001001011001001000000000100100001010001001010000001010000010000001000101101101101100
01000101000000110000100100000000000000011000000001001010110000100111000000011010010110011000000000100
10000001001000001110000000000010100100110010010110101000000000100000100001000000000000000001010000010
00100110101101110110000001001010000011001000001000000110010001010000011010100010010001101001011110001
10000000110110000010000000000010000001010100100010110000000010001110100010101000011000101001001100000
00001010101001100100010100100011000100010001000101010010000011011010010010100001100000010000100000100
01000011001000100011010000110010010101110100100100000100001000000110000000110000000101010000111000010
00011100011100011100010000111001001000001111011110110000010001001001101000001001000100000000001010010
10000000111000100000000010001000000000000110010000010100000000110000010000100000000001000010101000000
00000001001000011100100011001000001001000100000001011010000000000100111100110000100001100010101011001
10100011100000100000000100011000010101001000000001010000000000000001011000110000000100000100110000001
00000000001000000111100010001001010001100010010001100000100011000001100000011000001000100010000110000
11000000001001110100000010101001000001000010000001010110001100000100000000100010000000100000100000000
00000110110110100111000111100100100011001000110000000000010000100001000011101000010100101101001100010
01010110100000010000001100000110101001110011010000001000001101101000111000000001010001001101001100100
00100010100001101001010000000000001010110100110010000000111000100110110000010000110001001010100000010
10000001000110000010100000010001000000010000000000000010011000100000011010010011000000011100010011000
01000000100001000100001110001000000000111100010000111000000001001110010001000001011111000000010000010
10100010001110001001101010000010000000100001100001000001000001000001001001011000100001011010100000000
00000000000000100001000000000000001000000010001010100010110001000000110011100000000010000011010000000
00001000000011000000010001001100100100000000011000100110000001100001101011101000101000011111000001100
01000011000000000000001000100011100000110000010000000100010110001010000101110100110100010001000001000
00110110101101000000000100000000011000000001110010110110010000100000001010010001000100000001000010101
01001000000110000100110110100011100111101000000100000000011011100001010001001000100011001010000000001
00000001000000010011001010000000110001001101100100000001000010001000000010110010010001101010010011011
00011011001110110111000011010011011110000110011011100001000100011000011100000000000011000100000101110
00000010000011010011000001000001000000011000100000010011000110000011000000000000100000010000000001001
10010100000000011100011000000001011000101011000010001101001100000100100000000000101100111000000010001
01000101100011000000011000001100010100010000100000101100100101010010000110100001111011010011010010000
00000010100000010001010010001011001011110000000010101000110111100000000101000001010000000000000100010
00000101000001000001010100000100000001100100000010000000101011000101001000000101000001011001000001100
00000100100001110000010011000100010101100000001000100000001101010001000000010000110010000100001000001
10010110000100110011010000100100010010010001000000000110000000001000111101110100000000100000001011100
00000001000000000101110010000000000100011001000010000010011100010001010011110001001101010101100100100
11100100001100000100010011000000010000011001001000101001000000000010000000100010001000000101100000001
00010000100111000100000110011000010100001100010100110100000000000101000000001000000010001101100000000
00101000100000001100010101000110110001110001010000001001001100000000100010000000001001000000000000100
10011100010101000100110110010010100000001011110101000010000110000010001101000001010100000001100001110
10100010000110100100010000010010100101000000000000000100000010000100000001000110011011000011110001101
00000100010001101000100001100001000101000111010010010001000001000001001100010001000000111110000110011
01000010010101000100010010010010000000000010110000001000100010100110100001000100001110000010010001000
00101010001100001000111100000000001000001000000110010010000100011011000011000010000100000100100010000
00000001000000000011100000011001000001100011000100101011000100001100000101001101001101110001100010001
00100010010001010000000100000110010000011000100001010010000000000000000001001101000001010010001011100
00100100010000000001010010101000000000010010110000100010000000001001000100000000100000010100010000001
01001000010101110000100110100000000000010000011001110011000001011010001000000000100000101100000010010
01000100100001110011001000001100000010000010000100000000000000110011000001000000100100100010001101001
11000100000110000101011000001010110000100100110000001001101100000110000110100010001001010100100001100
10110000000001001000010000010100100001101010001011000010010001000011101100010110001001100000100110010
00000101000010011001000001000000010101010001010001000000000001111000101100010010111000110010001110000
01111100101100001010001010010100000000000100111001101001000000011000100100110000110000001101000000000
11110100000001010010000000010001000000100001110001100001000101000011000100001100000000110011000001000
01101000101101010001000100100000000010110010001100000000000001110100100000000000111000100010100011000
01011010100000000000100100100000010010100010001000000101011010000000001001010001000000011000000000011
00011111000000101010001001000000011100000011101000001000000010110000100001100100110000010001000000000
00001001100000010010010110100100001010000100000010000010001000110000000000000000010001001000000001000
00000100001000100001000010100110000100000000000000100000100011001101100110010100000010011010001000001
00101001001001001000001000100000001011111000100010110000000001000000001110001000010100000010000110000
01100100000001011100000001000000010100000100101000000000001000000100001000100011010100010000000000101
00001000100000000100000001000100000101001110100100101011000100000010000000010101011000000000110101000
10100000000011011101001110000000001000000100000000000011001001000000001000000010100000000010001100000
10011001010010000101000011001100000000010001100010000101001000110000101110000000101000000000100010100
00000001001101000100000000110100001100110010000001010101010000010000100000100000000001000111100000011
10000001000000100000010010010000000011000010100011100000010110001010001100010010010001001000000011110
00000001000100101100001100010000010000100000101010000000100110100110011001000101000011000000100101010
11000111010001001010001000101010101010110000101010010000011001000000010100100100000000100000101000000
01001000000101010001000000000001000010101010001000000000110100000000101000010000010000001110110001110
11000110000000011001000000101101101010010110010000000001001000000101100000100100001111000000000001001
10000000000010001000000100000100011001000110000000010100011010000001010110100101101100000100001001001
00001001011000000011010000011101000010101100001100000001000110011110101001100000000010000001000010001
10011010000100010010001000000111000000010000000111100111001000010000000100001101111110000010010101000
00100001101000110000100001111001001000010000110011001000000011000000011000010100110100001011000111001
00000110000010001100010000011000010100011001000100000000011100000000110001001000001001101000010000001
00011000010011011110111000011000000010100111001011000010010000101000010101010101000001000000100000010
10000100000000101100000011000111001001110110000010000000111100101110001000000010101100011100000101111
00010001000001000000010000000001001100010000010000001000000001000000000001010000100100000010000000100
00110100001001100000001100011100000100000000000001000000010010001000101001011111000100000001100000100
10001000001110100100010110110000001000010000000111000000100110101010101001110000011100010011000010001
00000010010000100110011010000110011011001110010011001000101010110100010101010100110100001000100010001
00000111011100000001001000000110000001000100011000110101000000001000010100000000110000000100000000001
01100001001000100000100011010010010100010100000010000001101000010000000000000000011101100000001000010
00001000110010000000000001000000100001000011100101000110000000111000010110001000110100100100010000000