68,56
46,8
00010011100000011100001010101101001011010101000100100001010101000001011001100001110000010110000011000
01000100000000100101010010000000000011000001000011100100010000010001111000001011101010001000110001000
01000000100101100000001100010010101110000010000100000110100010110010000000000010100010110001000001000
00100001100000000000010001001000110100011010100000001001101010000000111101000100010000001000000000001
10100000010101010010010010000010100001000000000010101000011100101000101100010010000010001000010100100
00000111000101001010101001001001010010010110000000000000001001100010000001001100100010110000000010010
01000100001100000000110000011010000101100000000000001010010010010001111101000100000000100010010000100
00100000000010000010100000000100001000100000000011010010000000001100100110000011000100000000000010001
10010010000000101100100000011000001100000110000000100000100010000010100100010000000000000000011110110
01110000000110011000000100000000101001100010101111100100010000000100000010000110001101000000001001000
00000111000100010000100001010001010001001010010100100010011011000001000010100011011000100001000000100
01100000000000010000010000000000001101000001111000101000110000000100000100011000110010001010001001000
10100111000000010000000101010000001110000000010000010111000000001100000000110001100000001010010010001
10011010011011000100000110001110000001000000000000000010000100101010000010101001000010100000110111000
11010110011011010000100100011001110010000001100000100111000000101000010000000010000010001010100101010
00011000001001000010000011100000000000100010000000000010010000101000010010001000010011001000000000000
00000011000001000000101000111101000111101000100011000011010010000000010011001110100000100011100010000
00010001000101001101110000110010000001000010100100111101100101100001001001000010000100110010100100000
00010000001010100010001001000110000111111101010010100100000000001000001001101001101000100000000000000
00111010110000001000011000000000010001001100111101101100011101000011001000101001000111000001000100001
01000011010000101000000000010100000000100110011100110100010001001001000001010000010111010010001000011
00000001000010000000101100110101000001100000001001010010000010101000000110000001010000000000110000001
00000000010001000000001000100011000000111000110001000000001100010111110001000010011010000010011101010
10100000101001000000100000010000101000000000010000010001100000100000100010000010100000010000001001000
01001110101100101001010000010101000001011000001000000100000001001110101000011100000100000000000010110
10111000000101000101000110010110000000001100001000001101110010010000001000001000000000011001100001010
00000000001100000010100000100010000000100010001001000000001011000000000010000011000000000000000000001
00000000010111001101001010000110100000001100100000011001000101000000001011110011001000001111110011010
11010110000011000000010001010100110010100000000100000001010000000011110100100101000010000111100001100
00011011010101010100000000000001000111000000010000001001010000101010000010000101010010001000000000000
00101001100010001000110010110001010100110000101101010010010001000011000011010001110000001010010000001
00010101100001000000000100011100110100100000000001000100010010100000000010001001000100000010010010000
10100000000100001010001111001000101000100000001001000011110001100000000110000010010001010011000000100
10010100001000000000010101111000001001100110110100101101000100000010011101000001100011100010011100000
01010001000100100101110010000110110001001100001000001111001100001001010001101101100011100001001000001
01111001110010110101000101101110110110110000011010000110100000000000000000010001000100010000110010110
00000011000000110001100101010001000100001000010100000010011000000100001000010010100001000100001101010
00011111010001101100110110000001011000011100001001100101100000101000100100100110010010100011100011000
10101100101010000001000100101000110000000000100001000010000000010010010000000001100110001001000011000
01000101001100000110100100000100001010100000001000001011001110100001100000001000000010001000011010000
10010000010000000100100010011001100111110110000100000000000001111100000001000010100001001000000111100
11000000000001111010101011011001110111000111000100000000000000001000000000000100000110011100000011100
10110000100000001011001100001000001000010100010101000010100111100010101010010000000001010010000000001
01110000000100000011001000011001001001010110000110101101000100110010111100000001000100100001000001000
00011000000111100111110001000000111010101000100100001101001111010101010000001000011100000000100000101
10000111000100001001010101001101000100100010110000000100000000001101010000001100011001000100010011000
11110000011000111100100000001000000011101001011000000010011010000010100000000000000000000000001101001
00000001000000101100000010101000010011000001000110010000000100000110100100100000000011010000101011011
00000011011000000010010001000011101100100110001000000110101100101000001011101000110000000101000011001
00111000001101000100001001100101000100011010000100100001000100000001101101100000010000111100010100100
10101010001000100000011010101001000000000011101001100110000001001000011011000100010100100011000010111
00101111110000110000000000111100000010000100100000000000100000110100100001100000001010010000000010000
11100000110000101001100010101101010001110000001010000001001100000100100000001000000001000000000100100
00101001100000000010100001001100111100011001100000001100010000100001100001000010101000000010100010001
10010011111101000011100000101010001000100000100000000001101100000000100001000010100001000000000000100
01100001000000000000010001001100101101100000000111010001110000100111100001000000000010110100000000101
00010100010010010101110010001000110010000001000000001100000010011000101100000111000000000000001010100
00001010001001011111111001000110010000110000010100100001000101011100100100100100011110000010000001100
01000100000010010000100001000010010000010011010000110100011100010000001000100000100001101111010000000
00010001001000011001010011001010110111011110111000100100010000000011100010001010001000000100001101000
01000010000100010001000010110010110010101000001011100011100010000000000100011001000010101001101010011
00010110001000110001101000011011000001011000101101000010000000010100000000000100010000000010000100101
00011000001101000100000101100000001100001000000010110000000110100010010011000101001000000000011010000
11000010000100000000100000101001001100010001001000000110000111001001011000010000001100000010000000000
01101001000111010100001101010010011010010100001001101000000000000000110001100110000010100000000100110
01001010111000001000010100000111000001100000000001101010101010100010111000000110010001010000111010010
00110101000100111111000100011000000100010000000001100000100000000010010001111010100010000000100000000
10001000001000000000010101010100010010011001011000011100000110000000100100000000001010100011100000111
01010101000000000000110010100000010110000101000011000101000101000000000010111000000000000100110001000
11010010000000001000011000100000001000010011111001010111110000000010011000000100000101011001001100001
00100001010011000000100011100000100100001000011100001000000001000100111110011100000100010011010000100
00000110101001010100010100010000001110011000011001000100011100011101100100010001100011100001000000000
00000011100000000010110011101100001001010000000101000000110100101000001100010100000000000001011010001
00001000010000111101010111000100000111000001010000000000100100010010010011101100100011100100000000101
11000000000000010011000001110111010100000110100000101010001001010101100001000010110011000000000001000
00010000100000100001000011010000111001100100111101000011000001011111011011000100000101000010000101100
00100100001100000100010000101010000100100011100001100000000000000110000000101001101000000010000000011
00100110100000010100100000000111010010011010001000010100000000010100000000010010111000001000111111010
00100100101000000001101011100010010101010011001000000001010111110000010111000010000001100001001101110
10000010011010010001010000110010000000000010011010110010000000110001100110100100000010001001011000110
11100011010000010000000101011010000010010001101001000100001110111000000100000101011100001000011001110
01110011110000000000000100100101101101001000100001010000010010000100010000000001110001001110000001110
10001010001000100001000000100001011000110111000000000010100001001101010110000100000010110011100000000
00000001010001000100101100101001101000000001100000000010110001000000100101001010001111001001010000101
01100000000000000000010000001001001110010000000011001011000000000001000000010101001100000010000000110
10111000000000000111001000101110000111110000011110111010011000001000010000000000000001000010000001011
10000111001000000000110001010110110000100000100100100000000100111100001000010010101010000110010001110
01001111000111001000111110000000111000110100101000001001100110100000111101110101000000000110100011011
00001010000010011001000000000111010000010111001100011110001111100010100000000100000000010100011000000
00001101000100000110010100000010110100010001000000000011010000011001000000001011010000001001001100001
01001110101010000100100000100101000000000100011100111100000001000001010000000011011010010100011100010
00000110010001000111000011001000100011100010100100000101000100000001000100111000100001010000000001011
10000010010010000000001011110010011000101000000010100001000001010010001000100011100011000111011001100
00010101100001001100000000000010000001110101010000100010000001001010001000000000001001000000000000000
00100000001010101110100111100101110010000100010110000000100110001100101010000000000000001000000000100
00000100000011110000000010000000000101000010000110010100101000000000000000101010000110000101001000000
10110000010000000000100000000000100000000000001000110010001001000100000100010000000100010011010000001
00000010010000010000001000000001100000000000100000010110111010001110101101001011000001011010101001010
11101110000000001001110010011000101000100000100000011010101010000100000001111000001010000010010010000
10000001010000000101010010110000000110000100100010100101000000000010100001100010111010100001000110000
00001010000010100110000000100101010010010001010000010000010010000010000000000100000011000000001000000