22,100
39,62
00000000000010001001010000000100000000000010000010000000000110101111110011001000101011000100010010001
00001110100100000000010001010000001100010010001110000000110011000100011101000110010010010000001001000
10000111001100000110000000010111000010100001000011000001001000100000001010000010001010100000000100001
00000011010110001000001000111001001111010001011100001000000000010000111000100010000010100101010010101
00001110000011000100000010000001000001110001000110000000000010000110001100000000000000001100000110000
00011001001000100001011011001000000101000000100001000000000100000001100101000000000011001000100000001
00001000001110000000101110000100010000100100101111000000111010100001010011011011010001111000010111001
00011001000001100010010000100100111010000110000110010000000000100000000101000001000100000000000000001
00110110000100000010000101101100100000001010000000011010100001110011001110000010011001010100000000000
10000001000010010000010111011100110101100001101010000000010100000100011000001100110101000000001000010
01110000101101101101110100000000010101010000000000001001110001101011010000101000100010100011100100000
00010100100001110010011001010001100011001010100011000000000110011010100111110001101010100001000100000
00100011010100100001000000001000101011001010111100100111100110011000001100100100000100101000001010100
00001100011000010001100010001100100111001010000001000000110000000000000101110001010110100000001001110
10010001100110001000110110001010000100010111000001000010010001001001000110110011100110101010001001000
01000000100110010000011010001000101000100010010010100010000010000100000101001000000101000100010111110
00000000010000100100001010000000110010110000001100000001000000101100010010000001010100100010000000011
10010000000100100000000000101111000101000011000011000000000000000001100101110001001100000011000100001
00001110001000000101001001001110000000100000110000001000001000101000001100010000000010011100010101001
00000101001010011000000101000001000100000001000000000011001000010001000110000001100100101010000001001
00000100001010100000101011001001000001000001110100111010000100010100000000011010000001100010100100010
10001010110001000010010010110010111000011010011100000000011010111010000111010001000000010000100010100
00001001100100000001000101100010000011010000100010001000010110010000100100000110101001000101010000000
01000111000000000010000000001110000001000000100001000100000001100011010100001100001000011100000010000
01011000101000001000101011001100010100011000100001011100001101010000000000010100011011101111001001010
01100001010011000011000000000000100010100000111011000000010010100000001000110010000000110000000000111
00000000011100000110010000010100001101100001001110100001100000010011001000000011001000100010000011110
11000101000000000101101000110011000010100011000000000000000000000000111010000001100100110000001000110
10110000101100000000110100000111100011000000000100101000000010010100010110000001001010001100101110000
01001000101000000000011100001010000000010111000001000000100110000100100110001010101000001001100010111
01100011000010011111010000110100110010000000000100010000001100001010010001101100001010101001000100000
10000100100000001001101000000001101101001000100010001001001000000010101100000100000101110111000010010
00001110000000110000001001001101001100000001100001100001000000010101000000000001001110010010001011000
10101100001010100010001010000001000000000000010100010010100000110001001111101010000100110100001011011
10000001000001000001000100000011001100100011001100000001000001000100100001010111000010100010010101000
00000100000000010000100000101010001010000001000110111000111001110001101101000000101101001011100000111
01000100001000111010111101001100011001110011100000011000001000100000000000010100010010000011010000010
11001101000001001001010000110001001110100000111001101000100010100110100100010000010010010000011000101
01000011111000000110000101110000000000100010000111110001000001000100000010110010000100100001000011010
10000110000100001001000011101010100000010000110001000100000110000100010000011001000010000000001010000
00010010110001010000100000001010100100000101001000101000101010011000001000010000000011000011010001001
00111110001111100000000111000000001100010100100001001100011000100110111000010010000000001001100100000
01101010010000000000000010011101000101010000010100111000000100010010000001010000100101000100010000000
00010011010000010100110101001101011010111010000010000010001000010000000010011100011000000110110001101
00000010100000001000101100010000100100000110101000000010110000111100110001000001010000000010000000000
01011000000011000000011000000101000000010000000000101010000001110000010000001001000010010000100001100
10001100001101001100001010000100000011100100110000010100011011100000000000011000000011110110101001010
10001001100001100000000010001001000100000001100101000100000011100101010000110010100000001111001000101
01001101000001110000000100100000000101000010000001000100000001011000001000000001001000010010010110010
00010011100001010001010000100000111010001001000010001000101000000100010101100100100100001100100100000
01001001111100010000000000010100000101011001011001101110001011101000010101000101000000100011000010000
00010000000101001000100100101110001001000000110100010000101101000000001100000000100100110000101100010
00011111010100100000100001000010000000110000101110000001001010000011000000001110001101000001101101000
00000010100000000010000010000010010100100101100000000010000011011100001100010000000011000101010000101
10110001000000100000000100101001001100111100100100000000110000110001100000001100001100011001010001000
10101001100010100000001001010101010111000000000000111011110000010100100000100110110010011011100101100
00000010010010000001001001001001110010000001011101000100100110001001100010011000110110000101011010000
00000000000101010000000000010000010000000001010000110000010000010110001000001010000010100101000100000
11001010100011011000001110110000010001000000000001000110000111010110000000001101000110010000001001010
00010001000000000000101100001101101000111000011000010100001000110110001000000100010000010000000000010
01001001000110101011001001001010000100000101100110100100100100010000100000000101110000000001001000010
00000000000110000101110101000000011100000010000001000100001100000000001100100000011000100001000010000
00010001010110101010000001100000100010001001001001000000000000000000111101010010000010010011010001010
00001100000100000000011000000001000111101000010011001000010000100011101100010000100101010011111000011
10010100100000000101001011001000000010101111010100011001001110010100010101001001010100010001001100010
01100000010001000000001000000001001000000000010000100010000101000110000100010000111011000000101000000
11011000000011010110000000110000010011010010011100001010000000100100100011000010010000000000001100000
00000101011000000000000110001000100010000001000111000100001001010101101000100011010000000101100000000
11100000001010100011111101010001010010001000110011010100010000000001110010000101100000000010000010100
10010100010011101010101101000101010001011000110011000010001000100010000110011000000000000001011010000
10001100101110100010000000010011011000100001110000000001000100011010000100000110000001100000000100000
00111000000101000010100010001100100000001000000000000000000000110000011001000010000001111001011010100
01000010000101000000101010101100100010010000001001001111110000011000100100100000010101100110110000010
00001100000000100010110000001100011010100000100001100000000101100100000000001011000010011001001111000
00101000000010000001000001001101001010000110000100000100001011000001000000100110011101110011000101001
10011010001110100010000000000001110000000001100000101100101000001001000001100000000100001010010001000
11000000001100010000000100100000010000101001111000000000000000000010101010010101001011010000000100000
00000000101000101001010001100011000010001000000001010001001000000000001101000000100000000000000001010
00001100001011001111000011010000000010000000110000010001100001001000000100100000001101000001110001110
00001000000100010101000010000100100001000110010011000100110000000000001001000000010001000001100100001
00011000010101010010100001110001000000000000010101100000000101001000010100010000000000110000101000100
10000000000000000001000000101000011101010000100000000101001100000000100011001010000101001101011011001
11000000010000000100010010100100100001110001000101000010110000010000000000000100000110100100100100100
00000111001101011000000010000000000001000000011110000000101000000110001001000100001010101010100000010
00000001001100000000001000100000000000010111101101111010001010100011001000100010100000010000000000100
00100000100100001100000000111011100001100100000001000101100011001000100100110100010000010000011101000
00010000011110001110110100010000000010111101010000010100001110000010001000110000000000101010110000000
00101111000001100101001000010000101100100101011100001011001000000001110100010001100010100010010000000
00010101110001011000110011000001000000101000000001001010010010100000000010000111110101000001000010000
10011100011111000011100001000000101100000000001101001000010100000101100000001010100100101100001000010
01100110010001111100110101011001010010111000000110101000010000100111000010000100000001110101110001000
00001000001010001000010000000000001000110010100110100100000000000011100000100000001011001010000000000
00110010111000011000110001000001000010010101000001100010111011010100100101000001010001000110000000100
01101101101011001100101100000001000110000100000000011110110000000000100000011000100001100000000110000
00010011001000001000111100010100100000000011001111000000011110001101000110001100001000100000010001000
00010000100100101010010000100001001110110000000000100010000001000100100001010000001000000010000001100
10010000010110010000100001010001000100000000001000010001111010011000011010000001110111000000001001011
00000001010010100001001000001000000000001000000100100010000100100010000001110001011110001100010001110
00011100011101110110100011111000000000000000100010010000010001001001001100100000000100001000001100000
00000110010101010000011000010000001010100000000101100100000000010100000101001010001110001010001110011
01010000000001000000100000010100111000000101011010010001010001011100001001010100000000100001010000011