26,61
49,58
10100000000111001010000001010111100010011010001101100100010000001001010001110000000000010000001010001
10000011001000100111100110000000010001011001010010010001001110110010100001100000000000000000100010010
01000010101000000010000010000000000001110000001100011000000010000000110000010100011001000001010000000
00100000000000000011000000101001010000001000001100100001000110010100000010001000001000111100011000010
01001000011000010000000100000110000101011001011010001000010011011100000101000010100000000000100101000
10100110000100010000000010000100000000001000010010101011010011000000110000001000000100000000000000010
10000000000001111001001010111001000100000100000100011000000000000010100101000100000001111000011001100
01011010011010000010000001000000100000001010010001110100000001000000000000000000000000001101000000001
11000000000000000110001101100001001011001101111110000110001000000011010110000100000010000111000111001
00000001000010100100001001010001100000010111101100010010001000000101000001100001001110011000010000001
11010000000000000100000011000000000100100000000010100000000001000011001000100010100100010010010011000
00000111111000000011110110100000001101101100010000011101001011011000001100001010001000101000001000100
11010111100010000000000000000010100000010001011010011100100000000000010011000000111111010000010000110
10000100001000001001000001001000101000000101010011100001000110000110010111010000101010110011101001001
00110010011010011001100100110001010011000100000000000011100010110010000000000000011101100001000010110
10001000100001001000011100101001100001101110101100101001000101010101010000001100000001110000100011100
00000100000000000000011000001010011000001100000011000011001001100110000000000001000000000010011000010
00000000010000111000010001100001101000000000010010111011010100001000010110000010011000000001100001001
00001100010100101100000100000001010000000110100011001100000001011110001110001001011010001110010001010
00101010000101000011100000001100000000000100001101000101100011010000000010100000000011000101001010000
00000000000000100000000001000101010100110000100001000001110111000100010100000000110010010000000000000
11101000000000000100000001000000000000010100100000100110100000010011101010001011000000000001000100011
00100000000001101000000011000111101010011000000100000010000001101100000010101000101010001000000010000
00000000111000010000010000010010000001001001110010101000001100100000100001101010000001001000000010100
00010000001000000001001001000001001010000010000010011010100000000010101001000110101000010101001000100
11000000001000001101000001100001011000010110001000000100001001000010000001000001011001000001110010000
00001100100100001000000110000111000000001010000011000000101100001000000001010000010000000010000000100
11110000010000100010100010001010100010010100100000000100010010000100110000000010001100000001000000100
10000001000010000100000001100000000010000011100110001101000001001100100100010011000000100000000001010
00001010000010100001100100001001001000101000001100100011011000001011100010000000010010110010001000000
01000110000101000110100000011000011000000000011000011000000011001000001011000010001011110101000000000
10000000010000100000000001101000000010000000010000000011000000101000101000010000110000010000001011000
00010100010011100010011001111000000000010111001001000001000100110100001101100000001000101010000010100
01000100000000000000010000000000000011111000100000101010100001000000100000000000100111010100010000000
01100110010001110100001001010110000100010110000000100000000000010011000101010000100010011010101000011
10100010000001101111001010010000100000110000000001010001001000000001111000011100010011000011010100100
00000001000011000111010100101001000000000000100001001110101010011110010110100000000000011110001100000
11000110000011001010001010011100100000100101000111001100001010000011000110111001000000010010000100010
11000010000010110001111100010000000000101100000010010101010111001000010000010001100100001101000000010
00010010000101110101000001001000000000000000010010000101010000001000100011001001011000000000100100101
10110010101000000000001011001001010000001101010001001000011010001010000011000010000100000100000001000
00010010100011000000100010100011000000000000001010001000010100100000001000100111110001010010011010100
00000001011110000000010001010001010010100010010000010100100100100000000010000000000000001000000001000
01000000000100001011001000000010000000010001100000101000101010000001010001101001111001000010000000100
00011101000000111001001010100001010010000001000101100000001100000010110101010000100010000011100000110
10000011001010000100000100000001000111101001000010000111010101000000100100010000001110101010100001000
01000000100000100011000010000111100000000001001000100010111100000101000100000000000001000111000110110
10000011010001010111001010000111011000000110000000010000010001001100000010100000000100000000101000001
01010000100000010000010000010011101100111001001010001010001010000010011100010011000010010100100010010
10001011001010101011000001000001010001000000000000000000010001110100111010000010101000001100010000010
00001110000000000000000100110000000110000000000010010000000100111101100001001010101001000100010101100
11000101000000010010000001000011101000000010010011000001101001100010000010100000110111001000000100000
11001010010101000001000001100001001011000001111100100100000000000010000100010000001000100000000100010
00000000000000000100001101110100000001101100000000101001000000110001000001000000101001000011010000100
00110010000010000100000000000100000100000101010000000011001000000111100011000000000000001000000100000
00000001110010001001011000100001000110010100001001100000100011000110010001001001001011001000000001000
10000010000000010100101100000001000000000100101001100010100000000001100110000000011100001000101100001
00000001000000000110010100100100010101100000001010110011110100010000010100010100010100000100010010001
00011000010110010100001000101110000001000010000000000001000100100001010000011100100000010100100100001
00000011001000101000001000100100100001010000011110000110001000001110000001000100100010000010010100110
10000000100000100000100000101001000110010000000001011000101000011010100000001001001001011010101001000
10010000000101010001100010000011000010000000100000110000001000000011001001000000000000000100000100000
01000001011000000101000000010010000000100000100001000010010000001000100011100010000010010000001010000
01110010001000100000001101000100010001101010000010011100100011001100010001000000010100000110011001000
00000000100011000100001000000010000011000000001100000000110100110000100010000010101100010001000000000
00000001010010010101001110001000001100001100001000000111101001001100100010000000010010010001010100010
00110101010001001010100001010000101000001100000100000010000000011100000000101111100001001000000000000
11101011001000001010000100000100010001000111010000010000000000000001000100001000000100000011100000110
00000001010001000000000000010011000000110000100000101000000000000100100000000000000010010011001101101
01000000010011011100010000001100000010110001110111001000011010001000001010110000000000100001001000100
00000100001001000100001011110000000000111010110000100100100100000010111100100111100100001000101000001
00001001001110001011100101100010000000100000000010001010000000010110010100000101100001000100100010000
11100010110011000101001101011010100010000100100001011010011000000000010001000111000000101111000010000
00001000000000000010000010010001010101000010111000001000000110000010110011000111001000000101010100000
00010001011011000010000100100101110001001000110010100110000010100110000100011000000000001001010010010
10000001000000000000010101011010000100000010001100000011001001001001000000000100100010000100010001100
00000111011101001010001000010100100100000000000000010010100011101101010100100001010001000110010100001
00000110100011000000101000000000000011000100000111010000010000100001011000000100010000100001000001100
01100100000100001011000100000100010010010011000101000101000110000110000001100100000000000011110011010
10000001000001000011000000100010000001001100110101100001000000011001100001011010001000110000000010000
00001100001000010100110000110100000000000000000100011001010101000101111001100001010000010000000100001
10010000011100000000001010000000110000000101110010100000010001000111101000000010100100100000000011000
01000010001000001010010100000100000110000110010001000000000010100001010100010110000001001101010001010
01110000001100010000000000000110000000100000100110000010001100000101100010000000011000000111000100010
00100100000010001000010100001100010001010100000010110010000000001000100111100001100110001100000001011
00010100100000001001100110000000100001001010110000111001000010101001001010010101001000000101010101100
11000001110001000010000011000000100001000011000100001010100000000000000001011110011000010000010000101
01011100001010000101010100000100000111011100111001000100111001110001100100000000010011101010001010011
01101100000110010000000000000001010000000000000100000010110010110000001001111111001100000010010011000
00100010110111110101100001010000010010101010100010000001101000000101011111000011000010110100010000001
00001110001000101100010010100001000101110000000000000001011000001001101100000110000000000011001100000
11101001001100000010000001000001000000000001001000111000001000000000001011000001110100100101100110000
10000000010010100000101000000110010010010010010000110000010110110000001110101001000101110001010101000
11000110000000010000100101001000100010000001010101000000000010101000000000000000000100110100001001101
01000000100011000000010100000001001000000000100000110000100100111010000011101000010000000101001001000
10011000001110000000000100100100010000001000001000000100001000000000011001011000100001001000000000100
11101110010001010011100000000000100100001000100111101000011101100100000010011001000111010001100000011
01010010000000011000000000011000000000000001000000101100110001110110011100001011000111110000000100101
01010000000000101101010100001010010100101101110000000001100101100001000000010001010001010000000011000
01011010001000000001110001000001000000000000010000000000000101001100010100001011100000001100100010000
10000001000000011100000100100011000110110010011011001000110100000000000011100001000000110101001001110