21,58
61,75
00000000000001000010100010000000101101000010101000000000000011000001011010000000000000001100001100100
10001011101100101000110010100000101000000000100010000000000010010100100000000000010100100001000110111
00000010000000100000000110001011010000100101010001000000011000011001010000010000000100011000000110010
00000110100100000000000101100000110100010001011010000000000010000100010000010010000001000000100010000
11001000000001110010010011010000000001000010011010100000000010000000001100000000000001111001100000100
00001000001001001110100000001110000000100000000011010001000100000100011110000010010011101100100010000
00100111110001000000000101000000110001001000001000000000000000000001101001000110100100000110100101000
00110001101000001000010001001111010000001001000001010000000010100001000000010000001001000000001001011
01000110000000011010101000101011000000000011000011000000001010000101000100011011110000000000010011100
10101000001000000001011010001100010010110010000000001000000010101001000010001100001000010011101000100
00000000000111110001000011001000100010010000001000000111010011110101000100000010000000000000100111001
00000100000100000000000001010000011110011000100001100000100010101000000000100000000110000000010000000
00000001110110100100100000100000100010001000000011000001000000001010001110100101000101100010000000101
10100010000000010010000111110001110110010010011110001000010001011000001000011100000000000001101001110
11000100000000000011001001100001101010100100011111010110101000100000100000001000010010000010010100010
00100000010111000001000000010011010000001001000111100001100000001000000100010100110110000000000010001
00000100000100010001100000100010011000001000000000000100111000101010001000001101010100001001001100000
01010100000000010100100010100010000000001011100000100111000010000001000000010000100100000101100000010
10010010000010100110100100000000000110001001010101000111010000000000000110100110010000100101100001100
00100111000000001101000010111100001001000010110000101000000110011001000001100000010101101000000100000
00001001100001100001000010000000101000001001000000001000010001101010100000001001010011010110100000011
00001101100100010000100011101010000011100000100000110011010010001110100000101110000100000001111011011
11000011100100010000000000000100010100101111000001010010100110110001110001001010000001111000010010000
00000000000001011001010100001001101000001011000011100100011001000100001110100010010001000000000110011
00111010001010100101000001101000101000100000010011000101000000100001000000000000001000101001010001100
00110100000100000000000010000100000001100110101100011110000000100010010010000000100001001000000001010
00000011001000010010000010101000000000001001011010100101111000000000000000010001000110010010000011000
00111011100100010000000000000010000100001000000000100011011100001000101100000000010000010000000000000
01000010000011100000011000100001000001001100000011010000000010000000100001101001010001000000000110010
00010000110001111110100110010000010000000111000010000000010000000000000011000001000101001011100010000
10110010001110100000000110010100010100110100000000100001100000001000000000001010000001100000001001001
00101000001010011110010100101010010010100100101100000000000100100010100110001000010100000101100011000
10000011011000010001010100000000011000100100000000100100000000000010000100010100010000100000011010101
11000010000101000000101001000010100000100010111000111000101100000101000000000000010000110000101000011
00000001011000001100011010010011010000011001001100000101100100110010110001000101000101010000010101001
01011000001001100001000000001000000110000100101000000000000010000001010100010001010100101000001100011
01101001100010000000000101010010010000001000101000010111000000000010000010010000000010010000000010000
10011000101011100100000000000100100000001000100001010101010000011010001000010010001000000000010010011
11101010000101000100000110000001110100011010111010100000001000010110001001000000101100001011101001011
00000100001000000011000010010010010000000011000010011010100001100010111001100011001010100100001000001
00010010101010001000011010111101010101000010000100010001010101101000000001011010000000100100000000010
00000100001100011000000001001100000000010001001100000001110010110101101001000000000000000100101100100
00001000000001000100010000000000011000010000001100100011010000000110000000010010011101110000010000010
01100100101010100000000000101110001100000000000000000000010010100001100101100000101010000000100101110
01000000000011100010010000001000000000000000001000000010010010010001100000000110011110001100000001010
00000000001000010001010001000100101000101010110010000000000001010000110001000101001000010000010000110
10000000000100001000011101000000100000110001001000000000000010000000110110000000100011011010110100011
00001110100000101101100110101100010010000100000001011010101000010000001000100000100000000010100010110
01101001010101010100000000100010100100100000010001001010000000001101010000000000001000111001001001001
00000001001101010000001011110110010100001001000010110011010001000100000110100001010101000000100001111
01110100010010011001100001000000000010010000100000000000010001000000000010000001001001110100000100000
00011011000101100000100000000100000010100110000101010000111111000110000100000110011001001010001011000
00000110010010000000000010000000010000001110000100011100110001101000100000001010011010000000100000000
10000100010010000011101000000100101010100000000111100000010010000001110000000000000000000111000010000
00100000000001100000101101000100000010100000111100100000100000000101011000011100000010011001000100010
01100011001100000000001001000100100001000001000100000101111000001010110000011100000000011000001001100
00101001010001000010010101000000001001000010000110000000110010110000000000111000101011001000001000011
00000111010000100010001011000000010110011001010000001000000000001000000001010000000010000000001000100
01001101101101010101110000000101010100000100010000000000111000001100000100000010010100000010010011100
00000000000011010011001000100011000011011101011000000101101100000010110000100010010000000000100000110
00010110110001010000000011000011010110100001000010000000001001010100010010100010000000010111010010001
10110000000000001000000101010010010000010100001100000000000010101001000001000000000001100000100110001
10001100110100000001000110110100000101000001110001111011110010010000011101011100011010000010101000001
11100000110001100000011110000001111110010010000100100110100000001000000100000000000110100100110110000
10010000001010011000010100000000000000010001000100101010000010000010100000000011101000010100001010111
11001001000010000001000011100000100000011100000001001000010101001000001100000000101101111001000001001
00110001100000100001000001000011101100000001001000101100000000010101100000101001110011010000101010001
00001100000010001111100011000000100110000010000101000000100111000101000011110010000010000001010100001
00111000000101100000000000101110000100010000100110010011100000101000001001000000100110000001110101010
10011001010100010101100000000000000000100000001101100000010011110100101010111000101000001100100100100
00000110000001101011101001010100100010010010100000001011000000000000010100010000100000000000000000010
11100010010000010000100000011000000000000000001000100100100010000001011000100010100110000000000000001
01100001010011010100111000001001000010000000100010000100000100000001001110111100100010001100100100010
00100000010100010100000100000001000110000100001001010001001000010000010000010001011011100010001000010
01010001100011011000100001010000111011000110001010110101010000100011000100100000001100010000111100000
10110000001000000000000000100000000000010100001000110100110100100010100100000000000010101000000111100
10000001001001100000000010001110000000110001001000011001000000010001101100000101100010110101001100011
00000000011111001101100010000100101011010000001010000101011000000001011000000011000001101100001010001
00001101010010000011010001101111100000001000101100001100001010100010000000100001001011000111000000100
10000001111001000100000000000000000110000000100000000100100010000101000001000110101000000100000011000
01000000011000010000010000001000000101001001011000000000000000000100101000000001000001101100010011110
11001000000000000001000000000010010101011101101000001100100001000101000010000000000000000001001011000
00001100010011000010000111001100010100000001101101011101010011100011011000000001100011111010101000001
00100000000110010000000100101010110110000010001000000000000010100001101100000010010010111100000001010
00100000100001101110010000001010011110010000000101001100010111100000010010100101110110001100001000001
01001001000000000010010110010000100010001010010100000110100110011000000000110001000010001100010100010
10100000000001000110000000011110001000000000100000000000001001011100000000010001100000010101000000110
00011111010001010100000001000110101110111100001111111010010000001110000010100000011001110011011001000
01010010001100000000000101001111100110000001001000000010000000001001001000000001010000101100000000000
00000110100001000010000100010000010000110000000110000000000000100000000110010110100010000000000011100
01001001010001000000100000000000000011000000001000000000100000100001000100010011001010000110001001000
00001000000000000100101101011010010100100100000001011000000000010000100010000000000001000111100000010
01100011000001100100101001100100000000100000100100000101000100000010000010001000001010000000100110010
01010010111010100001000000000110010110010111110000001000011101100000000000001110101100010000000110001
00011110010000000000101110011010111011000000100000000000000000000110000001000001001111000110001000000
10001010101100010000010101000010001000010110100010100011111000010011100100001001100101000100000101100
00001101110011000110000001001001011001001000110000100000100010000000101111001101000000001101110001011
00000100110010101000000010011001011000000100000001001001001100011000111101000011110100100011100010000
01011000010000000000010000111100000000101000110101000001011001001001010000100000011000111001010000000
01000111110010100001000101000111000100100100010010100000001010101010010001010001101000100010101000000
00001000110000000101110100000001100000110100001100100100001000110001000110010100001001011000000100000