22,31
37,68
11011000101001000011110101000100100000000100001000100000000001100011010101010000101100000000001000000
10010000010010010000011101000010100001110100010000010011100011000010000100111000001100000110111100101
00101000001001001000101100000000000000000011001000100000010000001001000000100100010000001101000000000
01110000000000010000001100000000100110010100100001000100111000000000000100010100010101101001000001000
10001111001010010010001000100010101000001110000000000001110100111010010001111101100100010111000010001
00010010011000100010000001000000100101100000010010110110000000010001010000000001101110111000010001000
00000100100000000010100001000000010001100011110101010001100010001101111000101100000001011100101010100
01010101000001000000100111011001011110000000001000000000010110000010000011001000100100001010100100000
00000000010001000000100010000100101110000010010110100100110110011010000010100011000001100010000100110
11100000001100010000111000100000001100000110000010100001000000011100011001000000001001001010100001000
01101110010001001001000000000000010111011010000000001000010011000011011110000100011011111000100010101
00000000111111010010000000000110010100000101000001010000100000100010110000111100010110100110000000000
00000011000100000100000001011000000001000011000001000000000000110010101110000000100001001000010101010
11110001000100100000000010000101001000001010010000000001100000100000100100000000000100001101110000000
10100000100111100000000000100000000001001010010001101000011000000010000000100000010100100000000000101
00000101000010100000010000000010101001010101000001001000000000101100011101000101000010100001000001000
11000001100000010100000000001000000000111000101011011100101110101000000110001100000110001100000011000
10100000101011001010011000001000001100010010010000001100111010100000100011000110011001010100000001100
00011011100100111001100000010000000100100011100101001101000001000001100010000010010000101000100000001
10001000110001111001011011100000101000100001001100110000010010000000000000100000011100000000010110100
00010100101001010000000000101100001110000010000010000001000110000000110000001111101001010000111000000
00001000000000000100001001000000010100000001111010000001000010100010000000110110000000001000101011001
00011000000000111110000010011010000111001000100001000100100110001001000000000110111100010001000000000
00000001010010010000100000000010010100010000000010010000000000100010111101010100110000100100010111000
01101100000000000001000000001010101001010000000010010000000011100100000000101110110100110001010000000
10000010001000011000100000000100000000000100000000100010001010100100010000101000110001000010001001010
00000000001000001001011011100101101010011110000000100001010000100001010101000000101100010000100000011
10000010000010010100101000011001010000001000000000001000000101000100001011011111100001000000011010010
11011000000000010100000000000000110000111100001000000001001100000100010000001010000000100001100001000
10111000000010101010000100100110010100100010011000000000100010110001100010011100000001100111000010101
01000100000000010011100000100100101110100000011001010101000000100111000001111010000000001000010100000
00011011100010000010111001110101101000000100001000000100100010100100000101011111001100000000010000110
00010000000110010001100000001011000000010001100000101100011001000000000100000101000001000000000010010
00000001001000101010000000010110000100100001001000010011101100000011110001000000000001001100000000111
00011000000110111011100100010010000100000111000100000000000000001011000000000000000110001000100000010
00010100110100001000001000001000000000100101000100000110010010010100000000010000000001000000010100010
00000111000001010000110000010000110101000001010011100000010000110000001101100000000010011010000010001
00010001100000011010010110000010010000000100100000000011000001101100100000001110000100000000000000010
00100000000000001110001000010010000100001000100000000000001011101000100100000000001001100000010000100
01000101010011011100011110000011100000000101000011011000000100000010000000000000000100000001001100010
00000100011100001001011001000000001001010100001011011000010000000000010100100001001100000000001101100
00000100100010001000100000000001000010001000100010010000000001001100001110000001000000001101100000110
01000000001000010010010010100001001011000010000100001100101101000001100100000000110000100100101001000
10010000100000001000000000000110011000100000011000001000010000001011000111000000010011001011000100000
10100000000000100000100101000010000000000000000000101100000100011000001000010010000000010000000100100
00001000001000011000000101100010000111010000111000100011001000000100001000010110100001000110010001000
10011100100000001010101001000010001111100001000000001111011000000010100100000001000000000100010101110
00100010001001010100000000110000000001100001100100000100100100100100001000011010011111000000011000011
00000000001000000011001110000111010000000011110000101100100000000000001010001001000011110100000000010
00100100000001000010000001101000101101011001001000100101011000001001101001100010100000100100000010000
01101100000001000100001001000000101010001000110000100000101100001110110100100001100001011000001011111
10000101100010000000000011111000001011101000100110000000000110001000001110100001011001001100010010001
00001011011101000110001001000001010000010000100100001001101010001000000000000101100010011001000100010
00000010101000000010000001101010000000001001000000100100001000000000101000000000010010110000001000000
10110110000001101101100010000010100001011100101000001001111001110000100010000000100011001000001000000
10101101000101001110010101110001000001000000000001000001111000000011011000001000001001101001000100101
00010100101000000100000110110100000100110110001100110000010000100000000100001010100010000010111001100
10011100011010101000001001010001010000110000110000010001001000100010000000100001101110100100010000000
00000001000110000100000100110000010000010010100100011001011000010010010010000000111001100011101001011
00010000001000010100000000110001000010100001001010000010100000000001010100010011000101000101000000000
01100110000010111001100111100110110000010000000000100001101000101001001000000001000001101000000010101
10100000100101001000011000000001000010100000000011001001100100100101100010010000001100100001100100001
01010000010011111000010010001000010100101000001000110000000010000000011001001000000010110000000001010
00000001001001001000110000000010000000101011101101000010000001000000100110001010011011000111011101101
10100010001010000000100011110001000000001001001011001100001000000100011000011001110000000000011101000
00101011000100000011001001100101110100100101000110010101000000000110010111000010000010000011110000001
01000111000111000010100000101101010000011001110000011000110000010010000000000101010100001001000100110
10110101000010101000011000000101101111011100011111110001000000010101001010000000010000001010000000100
00000010101010110000000011010010001110101110000000100011101001000000010011100110000000100001010001000
00000001100101000001001101001100010010110010100000001000001010101101000000001000010010100001010110001
00010000000000000010011100010110100010100000001010000101010000010100010000000010100000001111010000010
10011001010100001101010000011110001000100111110101000000001000001010001000000100010100000110101000000
01110000010000000000001001000010001100100010001010000101000001111101000010100110001010000001100001100
11000010010110010010000010101000101000110000001010100101100010001000000000000100010100010111001100010
00000100000000000001111000011010010010111100010001100000000100010101000000000000100000010110101000000
10000001100000011100010000100000000111000000000010010000101100000011100001001011010110100001001010100
10000000000101001011011010001001000001101100111000011101000000110100001010000000001011011001001100001
00010110101000011000000100001000000010000000010000111011000000000001011010101010100000000000110000111
00001110010000101100011010000100000110001010010000000001111001000000110110000000010010100111010010000
00001010000010111000001000100111001000000000101011001100000010010001010101000000011010000110100001000
10010000110001010100001001000010100101001110011001011000010000011110011000000000000000001000011100000
00011010010000110000011000101100001011100111011100011000011001001000101000000001010000001000000000110
00100000010010100000001000100011001000111000101000101000101000000001110000001110000110010001000010110
00010101000001100001010100010000000000000100100110000001100001100010000000011000100111010100010000100
00001000100110000000010011011000110000000100110000000100000010001000010001110100100010010000000100001
01100001000001000000010101010001011010101110110110010011001010000001001000100111110000001000100010000
00110001011000101100101000000100010100001010000100000000010001000000011001111110001111000100110001000
01001100011110000010100101000000000000011000000000000110001110010101001000100101100010100110011010110
00101100000100110001000010010000011111010010011100000100000000110111110110011001000001001001000000000
10110010100011000101110001101101000000010001111110000000000100000000101001001000010100000100001000000
00000011100001010000000011001100000101000000000010101010100010010010000000110001100111010000110000000
00000000100011000010000100100100100100101000110110001010000010001000010100000001010000010000110011100
11010000010000000011000110000110100001000000000010001000000011010110100000101101000000000001000000000
00000000010000000001011001101001110000010000000110010110100010100000000100110110010011001000001010110
10011000101000000000000000000010100000010001001000000000000010000010100000100001100000000000001000100
10000001000000000000010000101010010011000000000001110001001000000010000001000111000110101100010000100
10010000000000010010000011110001010000001000011010000110001000000000100001010001000100000000100000000
10001010001000100011000000000000001000000011011000000001000110101000000110100000011100011111000010000
00010101100001010000001000010010111101010110000101000101100010000010101000000100000000010100001001001
00010011101101000010100000001011000011000000010000010001000010011000000000100100001100010100111001001
00101110000110111001001110100000000010001001000000010010000010000101110110111100101000001000111000100