48,24
86,91
00110010101000101010111000010000010100110000100000100000010000100111000100001010001010010100011001000
01000000011000100011000100010010010010100010100111000000011101100011001000000010000101000000000100101
11101000001000001110000011010000001100101010010100001010000100001000100101100000010110100000011000011
10000001000100000010101001011000000000100010000000100001000000100101100010000100000000000110100000101
10000001100001100001110001010010100010110001010110000011100000000100011000001110000000011010001111010
11001000010100100100100101110000001000000010100001000010100000011100010011000100100000000010010110100
00001000011101101110110000110010000001000001100111000010101000000100010000001000000000000010100001000
00100011011010010000100101010011011010100000000100011000000000111000000110111101000000000001000100000
00100010011000000010010000010001000100101100110000000011000100100100111000100100001000100110010010001
10000000000000011001101100100000101100100100000011000011100100000001000000100000110110101000000100101
01110000001011010110100100110000001111001000110000001010000000001000001010100100101001000000001001011
00010011001001100000101011100001100101000000100100111000000010010110000000100001000000001000001000000
10000000001001110100001000110011000001100010000100011010000010110100001000101000010010010111000010000
00000100000001000101100000001100110001010000001100000010000000000001001100101101001000100000000101000
00000001110101111100001010101001110000101010000010000001000000001101000001001000000000101110000000100
01000111000101110001110010000001010011101000111011000001001110000000010010011000010010100001001000000
00000000011000111001100100100010011010000011000001001001100001100001010000101001000011111100100100011
00001010011000001111010110010100001000000001011000100000000100100010000111100000001010001101000001000
00100110000000011000001000010010010001011001110010000000010100000000001010100000000011101100100010010
10000010000100111100110001010000001011001000001011000011000010000001011000101001100011100001001000000
00010011001001100001100010000000110000000100000100001000010001011001001000000001001011000011010111101
00000001010000110000101100000100000010001101000000001001101100000010000111100000101011101000000100011
10011001000010100000100011111000100001100110000000000000000101100010001000010110000010100100000000000
11000000000001000100011110011000010010000011001100010000001011001100101100000000010011100000001000100
00000010000000001010011000011100000001000100010000000010100101110100000000000100100000000001000100100
00000001000100000111000010011010001000100010011110001111001010011110000000000101100101000100101101100
10010100100000110100101001000110000011011000000100100111001000100011100111010001010100110101000010010
00100101000011100001000000001000011000100000010011100000001100011000110001010001001110000111100100000
00010100110101100001100010000101101100010101100000000001000100110000000000001001100000000000101000000
11000010000010001100000100001100100100000100110100010000100111000000100000000000010010001001101100000
10000010000000100010010000011000000000010010000110110110100000001000001000010101000010010110100010000
00110001000001001011000011011000001001110100100100100011100000000000001001010110000001100000000010100
00010001000000001001010011000111010001011000100000000000011100000000010101010101100000001010100011010
01000001000001100100001000000100000011010010001010001100111010110100000000101100000101010000010110000
00000000000101000010000001101000000010001001010000010010010010000001001110010101000110000000100000010
11010011000000101110100101110001010001100000101000000110000110100110101000100010000000010001101000000
01010000100110000000010000110010110110000101000010000101000100010010001001000000000000000000000001011
00000000101000010000010000000000010001000100001000001010100001010000010101000001001000110000100101000
00000111100000000100000010000000101000010110010000001010000111010000001000001010110100100000101000000
00000000000010001000001100100110101000000001000000001010011100010010000011000000000000000100100110100
00001110000000110100101101001010000110000001011000000010100110000000100000100100001000000000001000111
01100010100001000000010100010101000001100011110001111101110001000000001000001101001001001011001001000
00101100101101101001101010010101110000010100001010000111000100100001100110000000000001000010000100101
01000000110111010000001000000100101010101000001000000001100000010000000000000001001100100011000010101
00001111000100001000001000000111101000001010101010100001000000000010000110001000100101000000000001100
11100000000100010001001100101011101000000110000011000011100000000001010001000100000011010000000001010
00100011000110111000111000000001111011000001000000010001000010000000100000011000000000010010010000001
01001101000010100001110000010000010100000000000001100001010000010011000000000001011100000000100101100
00110010000010001001000000000000110011011011000110100111101011010000010000000001000100101000010100001
00100010100100011000011010110000101010011000101010000100010000000000010000000001000010011011000100000
00100000101101000011000001001011011001000001000000010100100111001001000010100000111100001000000011001
00101110101100100000000111001001000000010101001000101101000000100000101010000001000000110001000100100
10000000010010001001000001000000000110110110000100001000111100000000000000000100010001111011001100011
00000110011010000000110011000001101000000000000110000000010100000000101110101100011000000000011000100
10001000010010000100000000100011000000001000011010111100000000100100100010000000001000101000110101010
10011000001010101001101100100110110001100000110011001000011001100000110000001000100000110010100011011
10010000101000100101010100101001011100100111010000000011000010110000011100000001000001000101000101100
00011001010000001100000000001000010010000100100000100000000011110101000000001100000101111110011111000
01010100010100100101011100010001110101000101110000100111100000010000111010100100000000001000001101101
01010010110100010000000010011001000011000000100000001000110100000110010010001110001000011111010101110
01011010111100111000001010000100100000000000010100011000010100100010010000100011110000110010010100001
01100001010000001000001000101110010000010010101110000010000000011110001100001111010110110000000000101
11100110000001000100011010000101000001000001010100001000100110100010001101010001000100010010001001100
01010000010101001000010010011001100100001000100000000000000100100001000100000011010101001000100010000
00101001000000101000010010000010100100100001000000011010000000000000000100000010101001000100011100010
10000101000000100001000010000000000100000001010001001111011000000011010000000101010100000100010100000
00110000000000100011000011001000111000000001100001000001010110011100000110101000100000101000000110010
00100000110000110100010001100000000110000010100110100100000000111000001100000010001010111000100001010
00100001000100010110110011010011110000000110010100100000001111000000100000011110000000010100000110000
10000001000010100001111001000001010110100000000101100111101010001000100000000000100100000001000000001
11010100010111000100000000010001111000010001000000000001100000101101110100000011100000000100000001000
10011000010000010001000100001111000010000000100000000001011001110011101100000000001001000000000010000
00100000000000001000101010010000001000010000101110010000001000001000010011110100101000000001000110010
00000010010100000000100000000000100000000000101101011110110000000000100100110000000100001000010000010
01001010100000010000000101110010101110000101001000101001110010000010111100011100010001010010110001000
11001000100101000100000001010010010000001000000001000000001010000101100010000010010111001000000111010
00100000100100101010000000000011101111100101100111001000100001000110000001110100010000001001000010000
00000000010101100000101011001010000000010001011011000000000010001111111000000111010000001111100110000
00101001100000000001011000010001001000000010010001101100000011110110110000110010010111001100001000100
01010000101110000000010000100101000001110010000010000000110101100100010011000000110010000110010000001
00100110010011000010011101001010110001100000000111010110010010100100111100001000101001000000110000011
01000100000010100101000000010100111000000101000100010010001001000000000011000110011001101000011010000
00101101111000001000000001000111111001001100000100000101101000100100010001011000010101011011100000000
01000000100000001001000000010100001000000000011000100101000000001010100010101011010100010000000101000
01010001100011000101010000011000000001000001000100100000000101001110101010000001100100000010100010000
00000000010101000100010101010000001010100000001010101000101001110100100110001000100100000000011000000
00100100100000100010101001000010001001000001001101001001010100100100000110011001001011110100100100101
11000101100101000000001100101100001010010000010000000100110011000111010000000010001000000111111000110
01000000000000001000001100100100000010000011011000000001010110011001010100100001100100011010100101000
11010000110000010000000000000111010110100001000010110110111101100011001111011000000000001101000000100
10101000000000000000100001010110101001000000001001000101010000000010000001111100000000010010000010110
00001100001001000100010010111010011010000110001100100001010111011100001011000110100100000010000000001
00100011010000010000100000010100011001010100011100010110011100001000001001110010000000000011000000100
00100001110001000000010011100000101010000001000100100001100001000010100100000000001000010010001100001
00010000011000110011011000001011001001110111110001001101000000000000001010000010000000101011001010011
00010110000010101001010001000100011010100000010000001010100100000100100100000000000000000101001000000
10111000101010000001000000001000001010111001011000000110000110010100001000010000100111000000010001000
00001000001100000011101100000000000111110101001000011001100001100100100101010110000001000001011000101
01000001010010100000000111010011110000000110000101000101000000000111101000010011000000001011101000100
00000000000011000010011000010001000001001000001010001000000100001100110110010001100110001100100101101
00000000000100001010000000010100010000001101101010000100000110010000110000100000101011010011001101000