23,100
31,64
00000001001000011000000000100111010000001001010001110001001000011000000001100101000010100010000000000
01010000100000000000000110100011111000011100001000010011010011000000001000011100100000100111000001000
00000000100100111000010011100010000110000001000000010110001001000010000110001010000110010100001010000
01000010100000101001001000110000101010100001000000000001100000001000010000000000000000100111001000000
01101010100001100000001011000001000111100000011000100001000111100000111001100010101000100000000110000
10000001001100010000000101000000010100001000100101010100111000010001100000000001000000001000000100001
00010100000000100100010101100001010001000100010001000010110010101100011000000000001101000111100100000
01000010010010010111100010001100110110000000100000001100011001100111000001000000001110000010010000010
00100000000000000000101100000000010100000010001001001000000000000000100001000000000001100000111001100
00001010010100011011000001000000100000100000100000100010110001100001110000100000000101001000000000000
01001000000000000010001000100000100011101010000000100110100000110000010101110001000000000010011011000
00010000101001000010100000001001000011100101000100010100001011001000000101011000001010000000110001001
11000000001000001001010010100101000000000111010000000010101001010000011010101001011001111011011000000
00000010110000001000010011001001000101110000011011101000010111000100001001000111000000000010001100101
00011000000100100100010101001011000010001001000101100000101101001010000000101110010000000110000110000
11010010000000000100000000000001110001001010001000101000000000100111010001000011000111100000000001010
10100001110000100100100000010000010100010000001001011100000110001010000100100110000000001100000000000
10010110000000010000010001010000000111000000001000000011010001101001011000010111000011101110000000001
01000100001101000010100000001100010000000000000100101010110000011010110100110011100010010101101000000
01010001100010111000011000110000001000010001010100001000110100001110101010110000000100001101000000011
00111100100001000110000010101010110001001000001001100000010000000000101000011000100111011000000111101
01010000010010001100101100001000010100110010111010001000100100010000010001011010000100000100101000010
00001000001000010001010000000010100110100001000001011011001000011001101110001000010001011000101011011
00000000000000000010000000011000100000001000000010001100001101010001110010000000110100000010110000000
10001100000110000000010110000100001100000010000011011100000100110000000101000111101100000000000000111
00000000100101100001110011001010101000101100001100111010010000000001000001001101010001100100010100000
01000000000000100001000011111000100001010101110101010001000111000100011100011101010010110100100001000
01011000100100110001001101101000001000010000000101011100101000001000101100001110000010100000010010010
01010000011111100100110101000110000100111010011000011111001100100000001001100001000100001010000000010
00010110000100111100100000010000001001100001000000110100101000000000100010010010100010000010001000100
00001001011000000010000101010000111101110000100001100000000011011101100000000110000000100001100000000
00001000000011111010011111001101011010000010000010000100010000000010100111000000010101001010001101000
01110000101010100000000111000000001010000101100010001001011111010000011000001000100101100100110000000
01100001001011001000000100000010101000001111000100000010001000010000000010010011000100000100100001000
10110100100101000010100100100110110000000011100111011000001000010010000010000001011100001011000001011
00100100001010000000010011100001111000100000100110010001000101100000000100110010100111010111001000001
00000000010111011000001000010000100111111001001000001010000101000110000001010010100001010100000010100
10010000010110000000001010001001000011010110010111000000001010000001100010010000000010010010011010010
00011101000000110000100000001000100000010011110100001001101010100100100010000100000010100100100100110
10001101001000000111101010100110100101001010010100000111000011101010000100010100110001010100000000100
00000000001001010111000111001000001111000111100000101100010100010011000100100100000001101011010100000
01000100000000000100100000110000011011000001011010101000000010001100000111011001000101100100000000001
01001101100000001110010000000111100000100000100100010111010000100010000110000101101000100000000001010
00010000000111001100001000000011000101001100000101110001000000100010101010100001100100001010100000011
11001010100001000010010011001000000100000000000000110010110100011001000000110101010000101001000011110
10101010000001010010000000110000000000011010110010000010011110000000000011001000001000101101100010100
10010010001110010011010000100100010100010000010010111001010011000000100000010100010100100000101010010
10000100011010010100000000000101011000011110100000111110100000000001000000000010000000000001000100001
00010100001000001010001000111000000101000000010010000110010111000000100010100110100110000010001100000
01000100000000000000000100000011110001110101110100010110101000000000110001001000000100000011000000010
00000000000100000000000011000001000010010001001001100001011010000100001000100000101100001100000010000
00000010100000100000010010010000100100000001010010100011000010101100100100111100010001000001100010000
00010000101000010000100111100100000110011010000001010010000100000110001100010000000010001110100110010
00010010001011100000101011011000000010001100001100110000010011010110001100100000101101011010101001011
01000100011101100110010110010100100001101001000000000011001110010000100101100000001010001110000101000
01110010000010001000001000100001111000000001100000001010000000100000101011100101100100010110100011010
00000111001101000000000001000000000000101100100111000110000001100011000011000010000000000011000000000
01011000110000000100110010010000100000010000010100001011101010101000000000001000000000110001000001000
01110100000010000010001000010010100000110000100001100001000110100001000000011110110000110001001100100
11101000001001000000011110010000001000010100000110110000100010100110000101000010010000000001001001001
00110011011001010100100100000011001010000010001010110000110100000101000000000000000000000000010010010
10001010001100001010100000100000100100000100110011000001001101001001000010001010100110000100010101110
10100000001100000000000000010110010000000100001000010000110101001100010010101100011010110101001001000
10001000001101001000000100000010000000100110101110010000000000001010000011100100010010101011100110000
00100010000101001111010001001000001001001100001000111100011001000111000001000100000000010010000101000
00010000001100110110010000100000000101001000000000001010010011100000010010100000110000001000001010101
01110000001000110110011000010100110001010010001000100001101001000001000000100010010010000001100000001
00101101000100010000000100001011010010010010011000001001100000100100000100110000111101100011000001000
01101111100001010101000001010000110100000100000101110100100000100000010110000000000000000101000100110
01111001010000010110000000001001111111010100000001000001100000010110111010111110001000000100001100000
11101001100011000000000011111000000101010000000010010100100001001000010010110001010010000001000001001
00100000010000000101011001100100001100110100100101001100010101001001001100100101100100110011000001001
00001001100101000101010001000110010001000000001001000000101100110000000001101011011101000100001000100
01010000001011111000100001010011110010000000010010010000010000110010000100101000101100000000000010000
01011100000000101010000000000110100010000000001100010101101000100001000000000100101100011001010000000
00001010001010001010100000000011000000010111000000101100010000001000000100100110100000110000100110000
01001001101000001001101101001100000101000111110100000010010000010011000000000111010010001101001100111
00000100000000101001101001000000000110011110100110100111000110100010101010000100000000000000100001110
00101000000000000010000010000011101000000001000100100010110110000100010001000010101010100100000000010
10100001110010101100101101000011100011001101101100001000100100001100000000000000100100000001101000000
00100000011000110100100101000000101100000010100010001101001010110010001001100010001010100010001000000
00000001000010010000100100001010110010010000010010100000101010000000100000000000000101000010110100101
01000010000011000000001111100000110101000100001110110101011110010000100110000001010001000010011010000
10001000100000011001000100010000110110000000111010000100100010000011000000000010100000011010100000010
01101001001100010000010001000000000101100000111001100001001100000000000101001100010001001110110101100
00000000101011000000000000000011010000001000010000000000100100100000101000010011010000010000001000000
00000011001000110000101101100001000001010011010000011000000100011011000100010110001001000010110010000
01010010001100000100010001010010011100101001000111001100000000010100110000000001000000000011010100000
00000001100110001000010101101000100010100110011000001010001001000000001011010100010101100000010101001
00010100010000001000010000100010010100100101101011000100000001111000000101001101110001101101000110000
00000111000010101010100000011010011100100010001010010010010100100001000110100101101000100110010111000
00001000001100000100000010000010001110011000100000000000001000101000010000001000101101100001010011100
10100000000001000101010000110101100010000111011010000101100100000001100110001000000010010010000100011
00000000000100001100000000101000011111100001010001111011010001000000000001001000000010000000000100000
00101010100100000000000100010000111010101000000101101000001000010011100100011101000001000100000010101
01010010111000001101000000110000100100000000000000001010010100011100010100000000010000000010100000000
00011001000010001011010000000000000000001101000000011111010000010000000011101110000000100000000001101
00101101000100001000100100000010110100110100010000001001000000100111000001101000110011001010001110000
00000011110010001000011101100000001100000000101100000100000101000010110101010010000010001100101000000
00001000010000010101010100000000111100110000111000000000100010010101000100000001000001000011000001110
00001011110100000100100001101001010000000010010010110001000001010010001001000111101000011000000000101