94,29
68,4
11000001000010000001001000000011000010100000000101000000000100100000001001001111000100010000011100010
00000100100010100000000001001101100100001000010000100110000000000010101010000000100010001011110000001
00000010000010000010101001100001000000001000010101100011000100000101010110000000000101101001000011000
00000100000000101100100010000011000000010100100110000000100011011000000000000000000011100100001010010
11011001000100010100000010100000000001010000101000010000000011000111010000010010010010100000110011001
00110100001110000100000110010000000100010000100010111010001001010000100010010000100110100110000001001
00101100011000000100011000110000100000000011000000001000000100010010111000000001111100000001000111000
01100010000000001000001000000100100010100100000100000101010011000000000010001000110010110110010100000
00010110010010000000011000000110110100100010000000010000000000100101000001000111100100000000110001011
00101000001100110000111000000000110101100010010010000001010100001011000010100001101100001000000100101
00001010001001111100000000010000101000000110001001000000000011000000111000001001000000000000000000010
00010001101001000000000000001000010000000000001011001000000100100010110010100100100100000000000000011
00100000001000010100000000111111000100100000000110011010100000000000010100000000001010000100101010011
00111000001110001000011000000111101000111000010100001000001010011000000010010001100000110101001000010
01100100000000000100001101000100110001010001011101001001000001001001000011100000000111010101000100001
00110011000000001000010000000000000000000100000010110000000111000011001000000010100000011000100000000
11110100100010001010001100000110100000000000011000010000010100111100000000101110010110100101100000001
11011100011000000001100000100010001111000000001100001011101010000000000111011000010000101110100001110
10100011110010001000110001000000000110100001001010100000000000000000100010000111000000010000000000010
00100101011010100010000100110110110011101010010100111011101000000010101000100001000010110100001010100
00001001110001100000101000000011000000010011100011111001100010010000000001110001110010101000111000000
00010000101000110000010010111010001010001101000100100101101011001001000101010010011000100100100100011
00110001010101000000011011100000111100001011000010110000000000111111011101011000100011010000011000000
00011000001001100000000001000010001001100000100100110100100110000000001100000010000111000000010100000
00000101001010000000010100100011001000000101000010000000110010100000001101100111001100000011100011001
01101010110001100010000011000001000100011001010110110000101100010010000000000001001101000000000100100
00001100011010000010010001000011101100100000000010001001000000100010101000111010011010101000001001100
11001000110101010011000000001000001110101001111100100100100000000110010100000000011010011011010100100
00001000100111000011110010000001010000000101101101101000000100010010000100010100010101000001110100001
10000101100110101001000100111011011111000101001010000011000001010000000000000100010000011000011000000
00100000010000010001100010000000101101000101001100101010001000000010110000001110010001000000000000010
00001001010100000010010101000000111101000101001010000100010001000010000001000000010111000100000000000
01001010000001110010000000000011000101001000010000000001000011001000001101001000010000110100110011100
00011000000110000000101111101011000000100000110100100010011001110001111100000011001001011111000101000
00010100001001000000100000001001001000000011010010010000000010101000010000110011000000110011100000010
00101100000001100101000001000100010110000000000010101000011000000100100000010001001110010000000101110
00010011001010000010101001001001000000000001100100010100010001100110001101100000000000110000000000011
11100100000100000000000000001100000000001000000100100000000000000000101100110010000000011000000110010
00000111101011000011000000010000000000110100010000000000010000001100000000101111100000001000000001110
00001001001100000001010100000000000000011001010010001100000001000111110010010000001100110010100010111
00000100011000001001010011001100000100000000010010010111001110000101000000100011111100010001000001001
00000000101000101111000111000000010000000000010010100001100001000000010100010110110000000001001100000
00000011000000001000010000001000000000011001011010000100001000101110100101110001100010010111000000000
00000000000000010001000101100011000110011000100011000010000011101001001101000100110000001100000011001
10001111000100100000010100100100001101011010001000000010001100100000000000000111001001000000001100000
00000000010001001101000000001101001111100000000001100000000000000000001101001001110100100100000000010
00010000010000011110000101100010000001000010100011001100010000000000001010010110000101110011110001001
00011000000010000000011000010010001100000101010101001000001000001110010100000001010000010010001010000
00000000111000101000000000100001110000000100011000100000101110011101000100011000000011011001000101001
11000000100001000000100000100111010000011101001000010100101010000000100110010000000100101011011000000
00010000010110000011000011010000000010011100010000000000000010000000000000100010100001110000100010001
01110100011011010010100000010100100000100100100000000001110000010000000100001000000000000001000000101
01111000010100100000000000001000101100100100000111100100010001010000010110010000101101011001110011101
00101101100000000001000010000000000110000000000111000000010100000010110100100010000000100000000000100
00000010101001110010101001111000100010000100101100000100010100100000100000000000000110001001111000010
01000100000001001000000001000000010001100000000100010000110101000101001001010001011011001000001110001
00110110000000100101000000010000000000110000000000001110001000000000000100100110000100100000100100000
01100010010000011100000010100000010001001011111001101010101100010001000000001101110001011101011000000
10000100110000100000000101001111011001001001110001001010000010010101000010001000000001001000001000001
00011111001000000100000100010010011010111000001000001110100100000000010010000100100101101001100000000
01001101000010001011000110000101101001010001100010010011000011001001100001000100001100001000100100000
01100010010000011010011000110100101001110010100000110010000111010100001110000001100011011010100000010
01010111001001100100100101111000100001000000001000001010000010100001100000001110100011000100010101001
00100100100011000000000000000110001000001010000000010001100001000100000110000101111010000010010000000
10100000100001000110100010001010011110010011001000011001100110101001000110000111010000111100000010000
10010000110010000000100000010111100011100101000010000011000000111000010000000011001010001111000000000
00000000000100001000000100001100100000010000000011001100000110010001000011001000000010010100010000000
01001010000000000110100101001001001000001110010100100001000001011100000101010100000000011000010000010
00011010000000000000000101010000000000000001000100001000010000001100001001001100111010000000000000101
10110001001010001110000001100000001000101000001100000000100011110000101101100010001000001001000000001
00110000101011001010000000000110000100010010110000010000000000000011101000000001001000001101010111000
01110001001000010000000000010101000110000010101000111110001110000000101000001001101111110011000010110
10000000011001100100000111000010100000001100001010011011000010000000000000100000010000111010000001010
00101010111000100110100111000101011000101100101101011101110010000011111100100000000110011001000100010
00000011000001011000100000110100011000100000000000000001100010000010010100100010000000011100100010001
00001010110001101101111101100000100110100000010000010000110100000010100110010010001010000010010010000
10000010011011011101001001001000011100011101000010000001011001110001011000000010101000010001000000000
00010100100000000011101000000100100010001010000000000001101100101010001100000100100001010001000010100
10100010101100110001010010000000110000001001111011110000001000011000110000000000010001100000000100111
00001000000100011000010100001101110100010000000001100010000000001000010011001101000001001010000000110
00000000100100001100100001000010100000100100111010100100100110010000000010000101001101000000000000010
00000011000000100100001010000000011000001000010000101000101110101000010100010001010100100101000101001
01010111101001001100010001001100000000000011010001011010100000000001000110010010100010110101100000100
01000000100001101010010110101000000000111101000000101001101000000100001000000100000001100000000100010
10100000100000100000000000011101000000000010011000101000011010001010100001100000010010011000000001001
00010000000011001100100100000000101000001001000001000010100011000101011100000001010000011011001100000
01000100111010100111001000000101011001000000011000010001100010000000000000000000001001000010001011000
00110001000000000000101101000100011000100010000100001000000010001101000010000001010011001000000000100
11000011101000100001100100001011010100010000000010011100111000000010010000000000000000001100011100101
00000000110000101001011101011100000100000110011100010000000010011011001110000100100100111110100000000
00100010000101000000000000100001010000000110000000100101001010100011000100000000110000000100010100000
00000110000011000010110001001100110001000000100000000000010111000011100000010000001010100011010100001
01010100000000011100010101111000001000110000000000010000110010000000000001010001100110000100000010100
10001101100110000000100100000000110100111010101000010010100100000000101000000010011000100101100010011
00000000000001001000000010101001010100100000000000111000001000010001100100000010011100110100000101010
01001010100000010100000000100001001101001101000101000010110000000011100010010001001100110100000000101
00000000010100000100100100100010001000100000001000000000010001101111001110010101110000001000000010010
00110001000001000000010000110010100011010010111100000101010001000000010011000000010000010010010111010
10111000000000011110000010000111000010010010000100101001010010110000111011000011010000000000101001001
01110001001100111001110101000000001010010000001001000010000101011001001000001000000110100010001110000
11000100001001000000001100000000110000000010011000000001010001010100110100000000100101100011100000010