43,40
23,59
01010011001011100000111110011011000010111001100000010011100011100110000000000010001101100000110100010
00001001000000010010001010011000000000000000000100010001000001100001010000100100010001000011110000000
10011001001010001001000000000101001000100000100100010010100100000110000000000011000100001000000000000
00100001000000100010010000110101110000100100011001000001000011100000101000000010011000000000001000000
00010000001110111000101001101000110001100010000000010100001010100001100000000000000000011001001010000
10001100010111110011000000100011000101000100100110000101000011000000001001001100000111110010010110000
00100001110000010000010000000010000000000010111000011101000010110000000100001011000100000001011100000
00001000010101001100011000100001000100001001010000010100001011001010000000000111001001111110101010000
00001100011010100011001111100010100100011101001010111001001011001010000101000101111000100001110100100
10000011010010100000101001010100110110111100000001110100000010000000010000001100000001011011001000010
10101000101010000101100101100100100000000111101000000000110001000001000010000011000000000000000000000
00000000010000001100001010101110110110000100000001000000010100110000110101110000110000111011000010100
00000001100010011100101000001010010010000100100001101010000110000101000001011101101010100001000010100
00000010000111101110100110010101001101010000000000010000001100001001100110100000000010100001001011100
00110001000000011000111101011011110110100001101000101110010011001000100001010000001010010001011001011
00001011000011000010010100000010110000000011001010001010000011101000000100010010000010001010110000010
11000001000011000000001001011101001100011010100011000011011001100000000001010000001101100100010000011
00000101101001001111000001100001001000000000100010101010110100100101010010000000000000000101001101000
11000010000000000010010001000010000110101001010000000000000000000100100000100001110001001100010000000
11000101011010000001010100100010100000011010000010000001000001000100100000100010000000001000011101010
11000000101000110000100101000010010000100010001001000110010001001101000000000010000000010000100100000
11100001001010000000000000000001000101100010001100100100000110110010000000101001101000011110001001110
10000010000101110000000101010000110000110110010000100100010010100000000101000010000000100011000000010
10001000000010101000010000011000100100001000100010011101000100110010001000111100001001110001000001100
00110001000001110010010000000100010110001001111011000010000000000000000111000011011001001000011001000
00101001000100010000000000000010000000000001000000011000101100001100011100010001000000000000111000000
10001101100010010101011010000001111001000001000010010010000101100010011001110001011010000000110101000
00010100011000110100100001001000010011100101001100000011011000000100100100000001110000010110110011001
01001101001100001001011010000110101010000000101100000000010000000100000100010011000000100010010110000
00010010010010000001000011000000010000111010110000000100000100100001011001011001000010000000100000011
00000000001001110001001011000001000100000110000001001001010100001110011000111001010000101100000011000
01100011001101010000100100000001000100101000000010110001000010110001000000001000000000010010110001100
01110010001000100000000011110001010010000001000100110101010000001110100010101000010000010000110011000
00000000001000011011000101001110000001010001110010100101000000110101100000100010101011011000000100011
10011000000000100000000101001100000100010000010100011101000101101110000001110001100100000110000000011
00100001000100000000001000001000000000100100000010010001100100000000001100110000100000000111101101000
00101101000000100010100010000100000000011100010000000000000001000101010000101000010100010011100000100
01011100000000000110001010010011010011000000000001000110110100100000000000000101000000010110010010010
00000000010000000010011101000001010100000101110010100000100010110110100001000010111010010000100001010
01000111000010000010000001000111000011001000100100100101000001110001000010000000010000100110001000000
00100000000010001100000001011000000000000000000000001110010000010100000101100000011000110011100000010
10100001000001001000101011000110001010000010000010000000010000100000000011000000110000001000111010100
11001000011101001000001011100110010101101101100000100010000010000000011001100000011100111001110000100
10100100000000001001000010010001000010000100101111000000000100000100000011000011010101010100010010001
00100010100100110000100011001111001100000000110000111011001101000000100010000000010101100110010000010
11000001010011100100001010100000001001000000000110010101110000000101000000000001110011101010010100000
01000010000010010110001000001101000000000001100011001111000111000000000010101001110100100000000000000
10000001100001000010000010010000010010001100000001000010011000000111011010100000010000111000100000000
00100101111100001111010001100111000000010000000010000100000110011111100000001001000010000010100000000
00000100011000000000000110000000000000001101001101010001100110111010000110000000000011110010100000100
00010100000010101000000001001110000000100100100001000001001100001000000101000011001010100100000010101
00000000000001010000001001100100001010001010000000101010001100101110100100100000110000001000001001000
11000001000001001110010100000000010111000000000101000010000000000010001000101010000001011010100100110
00101010100111100000000000010010110010101110000001100000000100000101000101101010000000000001001000010
00100000000001000100001000000000001000010000000001100000000000100000000001110000101011000011001110101
11010000001100100101000000001100011110000110000000000001001010000001111000110101000010000000000110000
00100110101001100010000000001000000000100001110000001000011101110011001100100101110000001100101101101
10010000000000100010000000100000001101001010001011000001110101001000011010101100010001010101000001111
00011010010101111100101011001110010100000001010010000010000010000100000100100100100101101001101000100
00111110000000000010000100000010100011001010110000000010000000010000010000001100000001000100100000110
00010000000001000000100001000000100001000010000000001100000100100001011100000100000000110000001010100
00000011100010111001001000000000011000000001000111000100000011101001010001000000000100001010001000111
00010010011000000101111000000001000011000100100000010000001101101001001000101000001110101000000000100
00010010000000001101000000000000100000001000010011001010000101011111011100011000100100010100000000010
00000011101100110000001100100010100000000010010110000010100010000100001100001000000000000000000011000
00100100110110101101000001010001100000000000000000101000100100000000100111001000001000000001000000000
00000000001010001001011001000000101110000111100000000000011010001100000000010100001000001110100010000
11100010101000010010110110101110000100000100000000100100010100111111011010101111000010000001111010000
00100000000100010110010100000001010101000100000111000000000110001001000010000001010010000011000000100
00001011000100100000000011000000000000001011000000101100100000100000000100010101000110000000110001100
01110001010011101111010010001011000010010000000000001000101001000011011000000000000000010110000100000
00010010110101000011000000000001001001101001010000001000010001001001010000000000001000011000101101010
01001000110011010000100000010110000000001000100010010000000000000001010000001001110100000100001000110
00010000100001111000000000101000000010000000001110000000000110000010111000101010001100000000100111100
00110100001110000000101010000100011000110011010110011010110000000011011000100000100101001000001000001
01000101010110101000000100001010110100000001100010100001000000011000100101000001010100000001100000000
01010000001100000110111000010100101100100100000110010001010111101000100000100001110101111000000011000
00001000100000010001010100100110010101010010010011100000111100100100101111000101101011010100010000000
00100100110000101101010000010000000010001001000001000000011100000000101000000101111101100110110010010
00010000011100001010101000110110000000100000100011000111100000010101000000110100100000010101001011000
00010010000000000010011010001001000000100101000000100000000101000010100110110000000001000110000000000
01000010000001100100011000100000000000010001000000100101100000010000110000000000001000011000100001000
11011010000000001000001100000001010000011001000000010100000110000100000000000000000010110100011111010
10000011000000001100010101010001000000110000000000100110100101111000001000100011011000010000000100000
00000000010010010001100001101001011000101000010001001100110011010011001000110101001111010001011100000
10100000000101000001000010010000010000001010000000010000100011100100000001100000000000010110010010010
11000000000100001100011100001000000000000000000000010001001101000100010011001111011001100100000011011
10000010001010011011011100010000000010100010000100100001100000001100101001001100100110100000100010000
01011010010000100111010000110100000010010000111010010101000000000100011000000100100011000001101110100
00001101110001000110100000000010000000010100000001101110000000100100010101101011011110000011110000010
00100010000010000000010001000100011101110000001100010000000100101000101010000010100000000010000010100
10110000000000110100101001100000000100110100001010000000011010001001011001001000000001000001001111100
11010010001111000001001010010100001010000001001010000000001000000010000000001000101101110111001001010
01010001101011101001000001010110000000100001010000010100110000000010001000110000001010101001111101000
01000000100000010100000000001001110000001000000000100010100011110001101101101000001011010011000100100
00010101110110101001010101100000001100001001100010010000010000100000110000000000000110100010000010000
00111001000110001110000000010000000101000010001100111010000000100000000110100100011010000101011000100
00101100111000000000000000000100100001001001010000010100001100100011011011000110000000000110100000000
00010011000000001011000010000010010000110010110110011100001101101000010101001001000100000000010010010
00000001000000001011000000010110100010000000100001101010100000000010100010101000000000100001010110000
00111110000000110000000000001111110000110001101001000001101001100100100000011101000010011100001110101