51,28
11,68
00110000001000111000010101100011000001000001111010000000000010000011010000010000010010000010000011000
01000100001000010000100000011100001100000110001100110101000101100110000010000000010001010000010010000
00010000010011000000101010011110101000110010001011100000100100011011000100100101010010100101000000001
00010110110100100101101000000000101000011010001000100000111000010011000100100110111010010000000010010
00010001100110001010010010101100011000000000000111100000101110000001101011010000110000001011000000100
00101000000000010000000001010100100000001001101110010010000001010000000011001000100001000010110100000
10001001000000001001000000001011000000000000000110000100001010100001010000110111010001100110001100110
11110101110001000011001000000001010100000011010000000001000110000011000011010010000001000100010000000
00000101001001001010000000001000111100010101101110100000000100101000011011010001011000000001010010101
11001000001010001000111000110001100000010001010101000100010101010000010011000000001000001110100101101
00011100011001001000000101010000101110011000100101000010011010100000010101010000000000010010011000000
00000001000011001001101111010011000000010000001001010000101101000000000010010100110100001001010011000
10100110010000000010001010101101000100100100110001001000011011100100111010000000010110000011110001000
00010101000010101111001000000100001010000100000110110000110010001100011001000000001000000000111010010
00100000001010000011000110000100010110010100001010000000011011001001101000000100011011010100010000001
01000010010011010010010110000000000000000001000001010110000100000001110001000000100000100010000010100
00100000100000101000100110010111000000000100001000000000001010000000000100011000000100001010011010000
00000000000001000011001110000100010000001110000000001001001000000100000000101010011010000100000010110
00010001001001100110100111010100000100010010010010000100100010101000010010001100010100000111101110000
11000001100010000000010000010100001010000011101010011010010010000000100010111010001001010000011010010
10100000001000000010110000000011100001100000000000010100001100000010100110101001000001001100000101011
10110010100001000000001000110001001000000010000101001100010101000001101010101101010100000101000011010
00000111001001101001000101100000000100000001000000000000000001001001000010110000000000010000000101111
00101100000101000000010000100000010000000100101010110010001000100000100000110110000001101000001001000
11000000010010010010000000010001001111100110001010100000010100000000010000000001100000100100001000110
01001111011011010100000011010000011000001010000001010011011000000011001100101000000001000101000010000
00110100100001010111011100000101100001011000000000000110001001000000110001001000000100000010000101000
00001011000100010000101000100000010010001000101010010101110000110000000010000000000001111001011111000
10001011000010010100001100000001000000000001000111100010000000000110000110000001100000010000000000001
10000010000110001110000100010100000000000011100010101101110100000000001001101000010010000000100111110
10100000101000100101000000000000010010000000000000001000011110000000000000001100011100101100100010101
00010010000011000001000000010010000101000100010000100000000100001101000000001010001000100001010011100
00011001000010101011010010000000100100010010000100100101111010000000100000111010010101111100001000101
00000000000000010100100000000000011101001001001100100001010000101100101000111000100001001000000111001
11101010001000000100011101000000100000100010110100100010110010100000001000100101101000100000000101000
01001100111000000000001101011000101101000101000000101001011010110100000100100000010000100110000000000
00110000000010000000000001010010010000100000000000100000000001101000101001010000010010000110111010110
11000000010010000011011000010010000000001000000001101000000100100001001000000001110001010001100011011
00000101000111100010000100001000100000100100000000100011100110001001000000101000000101010010100101001
11100111000110100100100001010001001010000101000101010011000000100000010010001010010100001110001000001
10011001000010000001100100001101101000001000111100100001101110010011010010000110000000000000100010000
00011101000100100000100000100100101100000001111111100000011001000001000100001000000110100000100000110
01000001100010000000000010110000000000000000001001010000010001000100011000010010100100000000000010010
10000011010100000000100100000010000100000010000010101010000101001100011000100000000100001111001010000
10000000010100011100000000100100100110010000010110010001000000000000000000010011000110010110001001000
01001000000000100010011100111001100000001100010000000111000000000000000010100000100010111101000001000
11011000000101110000010100000000000001000000000011001000110001100010000100000100001010000000000100100
00111001101000110000000000000000001001100000000101101000000001000100011011000001000100001110011000000
10001011000011000000000010000100010101110101100010000101010100001000000000010000110000000010000000010
00110011000100011110100001010000000000011101000001100000010100010101000100001110010101010000111010000
00000000100010101001010001010100000011000011001001110100100010001101000011101110101000000000000010001
11110100010001100000011000100110010000100000000000001001000110000010101100100111101101010000011001011
00000100000000101000100000101100000100000100010100100011000000000010100101001000000000011000110000111
10101101100000101000100100010001001010001010001100100001101000000000100001000001100010010011001010010
00010010100110000001100000000000000100000000010100010010001100100100110101100001100110000010000001000
01001001100100001010100001111100000000100000011010000001001010000000010000111000011001100000010110001
00000100000001000110101000000000100000101100010000110000100100000010000101000000110000000010000010101
00001101100110110100001001100000101000100010000001011100101100000100100111000010000100001100011000100
11100010001000111101000110000001011001000000000000010110001011010000100100001000000100000000100011101
00100001000000011001000000001100011000011001010101000101000001100000100000000000011100000001010010110
11100010001001101110100110000001001011111000011000000100011000000010101010000000010000000100010000100
00110110100011110000001001000100100101101001000000000110100000100110010110000001110010000101000000001
00010000011000100000010010000000101000101010100011001001110101010010001011000000110101111010001000001
00001100000000001100011001100000111000001100011110100010110110001010110011110000000110001100000110010
00010010010000010111000001110010000001010000011010001000000000100001100100101111101110010010100100101
00100100000100010001001100110011101011001101000000011001010101000000000011010000000110110100000110010
10101000010000100101010000100100000010010001100000001000101000000100100010010001100010001011000100001
11000001000000000000000100000110001111000101011000010000000000001000110001101101100000000000001111001
10100000000000010010000000001100010000101010001000010000011010010000101010110100100001000100011010110
00010101100101000001010100001000000000010000100110000110101101000010001110111000011101000000101111110
00100000100010001010110000010100000000001010000000000110011100000000000000000100011001000011000000000
00000111001010010000011110000000000000100011000010000010000000001010001000000010001000010000100000000
01000001000001010100101100000100001001100000010000001000110110010101011000000010011000100000010110001
01010000100010001100011001000101010001101000010010000010010001000010100000001000000011000001000000001
01100011110001010000000010101010000010001100000011001010001011101000000110000001100011001100101000001
00111010010000000100000000011000000001011000010000010001000001100000011011000111000010100101000010011
00000000110100010101010000000000101001001000100111000000101000001000001100000001101000110100100100000
00000000101000010100011000000110101101101000001000000010011000000000001011100000100000110101110001000
00000110010001000001000100000000001111000010100000000000001000001100000001000000100000000100001000000
10000010010110111010001100100001110010110000000110001100011101010101001011010110010010001001100100011
00000101011010110000000101001010110000001010000110001000000001000001100001000000101001001000100010000
00010000010011100000010001011000100001000100000101100010100000001000000100001001111100010001001100011
10000000000101000010110000110000000001011010110001010100110000000100001000011001000001100001010100101
11010010000010011001000000000100000000000000100111000000110000000010101010000001000100000000010010011
01111000001010000011001000010001011001101100001000000001001001001110010010000010100000000100010000000
00010010001010001001001001110000110000100101110000001010000100000000010000000010100110000000101100100
10010011010010000011000001000000000000000111111000001000100000101100000000000000001100000100000101100
00101010011100011000000010010010000000000001001000001010110100000000000100010000000100101110100000000
10000000001010010100000100100010000000000000000101001000000000101000001100101001000000000000101010110
00001000010100000000100000010000010111010000111000001110001000001010100010100001001111100001000100000
00000000000010010000000100101000010011000010001010000111100100110100000100100011010100100000100010001
10000011110100000100010010101100000010000101110000010100001100000000010000000100100010111001000000100
00100000011001100000000000100000000001110100010000000100101100100010000000000001100100101000010010011
01001000000001110000100000100000010101000001000100100000000000001000001000010000100010000000001001101
00000000000001000101110001110001100100110000001001000101001000101000110000100011000000100000100000001
00011110011110000001001001100101100010000000001100000101000000010101101100100110010101100110000001000
01001001100001010100100010000010001000000000101010000000100100110000100001110110000110100100000000001
00010000110000101000000000110000110010000000111101001010010011000000000000001110000000000110000000100
00100000000000100011011000000000100011101100100001100010100110101010000110100010000001000111001011001
00101000010010000000000001000001000000101100000100100000100111000010011001001011000000000010000000111
00010000000000010000010010001000000010100000001100100110000100000010000100001000000100010000010000100