84,33
34,74
00100000100010101110000000100100100000011010011000000110010110000000010000000000010001000100000010001
01100001011000000010000000001000100101000110110101000000000100010000000011001000100001000100100001110
00101100000000010000011110001000010000111101101010101100011101001000000010000000010010100000001101011
00000000000010000100111010100011011001011010001000100001000101100001001010001000001000110000010011000
00100000011000000010001100100011001110100001001010100000101000010000000100011101000000100110001000000
00010110101000101100000000010000000000000000100000000101100001100001110000001000100101110110000100100
00010000101011000001011000100000001011100000011000000000100011000001000001100000100110001001100000000
10011001000100010001000110011001000101100010111110001000000110111000000100000000000010001110011011001
00010000100101001001100011010000000001000011000101001000000100110011010010001010000000010000111001100
00001000001000001001100100000000100110000010110000110001011101000101010000110000011000010000110000000
10000001000000011100100000011010000001010000000110000001011010100000100001001100100100000000000010000
01100011100011010110010000000001011011010010010111000000000000100001100000000100100001000000111100101
10010001010101100001010001110000111010110000000000011000001000000011010100010101100110000010111010010
01000001000001010010101000100010000000100001000000010001100101110000000011100101000011100001000101001
00101000111101000100100100001000100010011001010000011010000010010000001111000001000010010000000000001
00000000000100000001000011010001010011111001000101110101000001100000001000001000000010000100000010001
11000011000101000011000000011000100100100000100001001100100110100001000000001110111100110000111101010
11000000001000010000010010101000000011010000000110101000101101100010000000001001000000000000001000100
00000011000001000011100100000000110000000001000000100010010101100000100011000000111100000000000100001
10000110100000000101001001110110101000000010010001000100001000101000000000101001110000001110010110000
10010001000000000000101000110110000010000010011110110000010010000101010001000101000100101100010101001
10000000000101011000001101001100001000111000011100100011100100101000001010011000001100010100000110000
00000110110000101011011010000101100010011001000000010110000110000001001010000000000000001000010111110
01100010101011000000100100100100000001000001010000000100010000001010100100000100000100001001100100100
01110100000001001000100011000100010001000100001101000000010000000001101000110111000011000101001000100
00000001010000100001000000010010010000000001000000000100100100010010111010000000001001000100001010000
00100000010010001101010010101000001100010000100100001111110110000000000110000000011100110001011010001
01011110100000010000000010100101000000001110010000000000001101000100100100000001000110101001000011010
11001000011001000010010000010010100010001100111110110000100010110000000100101011011010010001000000101
00001000000110001100101000000001000000100011100011011000000101000001000100100010000010011001010000100
01110101010100000000001101000001011100000010000010010100001011011001011011000010000111001000000000001
10100000011110011000000111111100000110000000001001010000010000001000101000000001000010011110000000010
00000000110110100000000101001010010010000010010000011000000000100101001010101001000000011001000000011
00010000000100000001101001010110110000101110010111000000101010000100010000000000000010010110101001101
01101101011000011000000101111000100100000110100100100001000001001000000010101100010100000000110000100
01001000010100001000010010000000100000010010110110101000000000001100000011000100110001000010100101100
10000011100001010111100100110001011000001010000000010110101101011001001000001100101001100010110100010
00000000101100000101101010111000001000011000000011110000000100010010010100011100000000000010000000100
11000001010001010000111010000000000000101010010000000101000010000001100110001110101111000001101010100
00010100001010010010000011110000100011101001000010100100000110110001100111001010000000011000101000101
10010000010001011100100000001100010010000010011000000010000010000001001000000100000001000000001111011
00010000000000101010001100010010000110000011001010000000011001100010100000110000010110010101000000101
00110110100010010000010010000100111100110100011000001101000001010010011000000000000000000000001000100
01000101100000100010000000001010000000010011000001101010000100010000010011010000101000001010010000000
00110001000000000110001000001000000001000000000000010101000001000001000001001000010000001111011000110
10001001000001100001000000001000000010010000000000000011000000000000010101100000000101000010110011100
00001011000001010100011100010011010101100011010010001100000010000000000101010110000101100000000001000
00010100100000000001001110000001110100100001001010000110010000010011000010001010000010000101011101000
01100000000010001100100101000100000101000010000000000010101011011100010001101110101001101000011010001
00000000000001011010001111001000000000011100001001001000010100110100001010101111011110100010001100100
00011000001001000001110100111001000011000000001000000000010111100101000010111001010000011010001000010
11001001000100001000000000100110000110000000000001010001000000110000011101000000010000000100000011000
10000101010000010111000100001110010100010101100001010000001001000010000000111010001010000101001000110
10010000100010000000001010000100001010000010000101001100010100000001010010001110101000000100000000001
00100010001101000000001101001000010100100000000011000000101000000100000010010011101000010010100010010
00010000101001101010000101010100000110110001100100000010010000000101000000000100110101000010001010000
01110110000010000110000100000011100000110001110001101000100100001100101110000100101101100111000100001
00010011000001100101100000000110000100000000000001111010000000001111010000001010000000000100000001101
00000000001010010000001000000001000010000000110111000101000100000000001000000010110100001001111010010
00000000100000111010001000110011000001000000000011000000100010110000010000101000000100110000100100100
01100000011001000000100110101010000000100000111011000011000000110000101010001010010000100000000111001
01000010001000000100001110000011010110000000000000001010100001100110001000101100010000100101010001000
10000100101000000100101000000000001100000000101010001101110001000000001000111001000010010001000101001
00101101101100001001010100101010100100000000110010000101000001000110000001101000100000010001001101000
10000100110100000000101010100100110000011000000000100001000001110000100110001000000000010110001000110
01000100011011000100101000000110001101100001001001011100011100010100001000001000001000000011000011000
00000011110000101100000100000000000001000010000000000110101100010100000010100100000011000100100000010
00000001001100000110100000011000001100001000000100001001101001000010000010011101000101001001010111010
00011010010010001011000000010111100101000000010001000000000010100100110110010000001100010000110000000
10000001100100100001001100100110100000000000000010000000000011110000000001001010100001000010110000010
01000100000000110010011101000000110000000000000010000110000110000000101110110010100010000100000110010
01010000011010100011100100001000110011010000101000010111000111010110010100000000001010100000010000110
11100000001000001010000010000000010001000100100101011100011010101000111001100100111000010110000010001
00001011011110000001001011010100001101011110100100100001011101001000001000000000110010101000011000010
00000100000011000000011011100000100000000110011100100101001001000010010110000100000000001000100010011
00001000000001000100011100001000010000000101010010000001110000001101000110000000000100100001011010001
00100001101111000010110000000101000101000000000000100000010001110100101001001000000000000010100010100
00100101101000010000000001010000001000000000011010011001001110100010000011001000010001001011011001000
00001111000000000110000000101010000001011000010100000101000000111000110001000101000000100010000011101
10000001000010000001101011000000101000011110111100011100000010010010000001000010010010000001011000010
00000010010100000001000000000001101010111000001000000000000000010000100001001011000001001000000000010
00001010000001001110011001011100000000001110110111001100000011111000100000000101101100011000011100000
00010000000000100110100000110001000000000101110010010010010000000000011001110010100100000100000100100
00110000000011100000100000000100000000000000110010001000101111011110001100101001010101000000001100000
00001100000010010010010010110111001100000001000000000100000000100000101000110000000100100101000100000
00100001111000000000001011011010000100000000000100101000000000010100010110001010100000011001000000100
00001000110100110011000010001101000010101101010100100100000100000000001011001110000000011000000110101
10011001100000010001001100010010001000100001000100100000110000000000000100001110000100110000000000011
01001110100101110100100001000011100011100110001110100001010000100000010011000011001110000000110100100
00001001000000000001110000110000011001000010110111111101000000101110001000000001000010100011000000000
00101000110010000000001000000001100000000010100010000000000000000100100101000100100010110111001000100
00010010100101111000100000111000000001110000001010001001101010000010100010011111010010000000000000100
00011011010000011000100111000100001010101000000010011110010001011000010001100000100010010101010000001
00110100001011100000000000110100110010010001010000011000001010001101001000000100100100001001000101000
00010001000100010000101010000000000000000100000010000000000100010001010000000000000011101101000100011
00011100000010000000000100000100010000010100011000000010010010000000100000001100111001001000001001000
00000101111111101110000010011000000100010001001100010001111000011111010001000000001000100000000100000
01000000101001000001000000000000100000001100100100100000000010101110010000111000000111000001000101010
00100001100101000011100000100100110000110000101100001001000000000000100100000101110100000011010110000
00001000000000001000010000100000011100001110011010000000111001000111000100010100000000000100000001001
00101101010010000000010000100101100100101001101010000000000111001111000000000101001001000011011001010