86,51
24,59
10101011001010011010010000111100001111000000000001001101000111100001000000000000011000100010001000000
10000010001111000110010011010001000000001000101000011001000010011100001111010100010011100001000001001
01010001110010000101010100110001000100010111100001100010000100000000010000101000000101000001001010000
00000001100100000000100000101010000101110100100000000010010110000100110010001100001000101000000000010
00001010010010000000001101000000101000100000000000001010101001101000000000100010000100110111000010101
00000100100110000000001000010000010000011000001001000001001000100101010000100101000110000000101010000
00001010000100100000000110000000101011000001000001100110000000100000001010000000101000001001101100111
01000010011000010000000110011001110010111000000010010000010100010010100010111100001000000100000000000
11101000001110000000100011010000011000001000010000100000000101000010010010011100000000010000000000000
00000000001000000110000000100101000000000000001000000011100100001010000000010111001011101100100100000
01001100000011100010110001010000000000000000010110010001010100001010001000010000000101101100010000100
01011000011010010000011000100000000000010000000000000001101000100001000000000000000011010100000000001
00000001111010000101111101001100000001001010100000000100011010001011100100110010100001000000001010010
00100000001001010100010110010010001100010001101000111100011000000000010000010010001000010000000000100
00010000010001011000000011110001000100101001001001000000000000101010100000001010110101000010001000001
10000100101000011100000000000100000101001000000111000010000101000010001001000000010111001101101001000
11000001010011000011010000001110000111000000001000000101000000010100001000000011000011101000000001000
00111001000010000000000000010000000000001000001100000000000000000000101101000010110100001000010100100
10011001101100000100000010010001000000110010100011001010000000101111000010010011100001001001000000001
00101100011101000110010100010001010000010000001001001000100000011010101000101000011000001000001000000
10000000001110000011000100000000001000100001110000101000010001000100000001011000000111000000001010000
01010001000010011010100001010000000001000010000000010000101000000000000000000010110000100000000011001
00010100000000001011100001100000100010000110001101011110000101110100000101000011001100000100101001100
00000001010101000000101000011000101000110100001011010010111010000000010001000000010000010110001101010
11000000001000000011100110001000000100000000000001000010000100000100110001000011101000110001100000010
10000100001110000000101101000000001101000000011110000110001010010000000110000001010100000101001010100
00000000000100101110010010001010000000001000010100001010100010000101011001000000000100010000100101010
10001001000001100100000100000000010100000010000001000011011000111101000001010001001001011001010110010
10000111110011100010110101001111011100000000100110010101000110000000000000000100000000100000110010000
11010001000000001000000001000010000000010000000010000101000110001100000001000000100000001010000000100
10000010000100110000100010111001100000000101101000011101001000100110010001100000001000101111010111011
10000100000100001100010010010001011011010010111000000010001001100110100100010100010001101110111100000
11110010000101100100110000111000000101010000010001000100000000100000000000000111110010010010001000010
00000101011000000001110011111010100001001010100000011111010000001011000101000000110101000000000110000
00000000000000111010101100001110100010000000010001000100000100000101000000011000100001000001000000100
01000001000100010100001000101110000110100000011000010000011101000010001000000001000001100000000010101
11000100100000100000010100000001000100000010000000110000000011000100000110000110000000001000100000010
00011000100100000011100000101001000000001000011110001001000000100010001011100010000000110100000100000
01000000000110010001000111100000001001010011001101011010100000100010010001000001001011101100000010110
00001100111000000110101010100000011010101000100001100001100010000101100001000110010011100010101100000
01011010000000010100000000001000000010000010110101000010001100001100101000010001100000000000000111000
00001011010000000111000010101100000000001000010000001111000001000100010011001010010000011011000011100
00010000000001000001001100000010000000000111110100100001000001010010110000010010001000110001000100111
00000000100100000101100000000001011001000100100001010001010010001011010001110001000000001101100000001
00100010100010001010000000001000010000000001101010000110100100101000000001100101010000000001001001001
00100010100000001000011000001110000000000110000000010000010001110011100000110001000000000101000010110
01100000100101101000000100100000001101001101001011010000010000000001100010110010000000010001010000001
10100010011000100101010010100011101110110100100010000010011000110010000101000100100001100100000011001
00000100000101000100011110000010100001100100000011101000000100110010100110010000010000100000000000001
00000010000100000000110001110100001111100000100110001001001001001000000100001000000000100001010000001
00101000000010011010001110000101010100000101001000000100001010000010000110100100010010000000100000000
00000000110010001000011000010000011011000010010000011000010000001000001100000001000000101101000000010
00010010101110000010000101000100111010011000100000011100000100110001100001010000000000101001100100101
11000100110010100010001100000001000000010001100000000101100001111000110100000000010100010001100010100
01010010100101000001110000010000000001000010000110100110000000100000101110100010001010000010100000100
00111000011000110001010000001010000010000001101001100000011001000010110010100001010100001000001000100
10000110000010110000011011010000010000110000001011000000001110100100011100000001001000001101010010001
00100000100000010010000101000000111010010000000100011100110001000000000000100010110111010000000000010
00001000000000000000001100000000100000010110110011000100001001111001010100100001110011001000000000001
00100000000010000010111110100000100101100000000100010011100000001100001010001100010000000001001000100
01100100011100101101000001101011000010000000100001000000001000000010001010100100000101000110100101010
00100101000010011000001001100011000000100110000011000000111100001110000001000100010011100010000100000
00010011000100100010001001101101010000001010111000011111000110000100000101111101010101000000110000101
10000000000010000100010111001001010100000100000100010110011011000000001011011000100000001001101000101
00000111000000100000010000000001001000101000010000110001000000000000010100000001001011110010111010100
01010000000011010000001000100001100110101001001010100000000000001000000001100011000110000010000100000
00011011000010100000001100011001010111011100100011001101000010000100001010011010000001110100001101001
11001100110000001000000000000000000101101100011000000000100001000000000010010000010000001000100101000
01100000111101111110100100101000000101000011010100110101000101010000000010000100011011101100000111000
10110000000100010000100011111110000010000110110110010000100100000000010001000100000001100000110100100
00000100001010000101011110110100000000000010100011000101001100010110100000000001010100010000100000000
00101000110000010010100000000001101011000010011000100000011001011100100001010101000000011100110000010
01100011000000010010001100000010011100100001001010000100000000010000000111010000001001000111110010000
00100000110000000000011000001000001100001010010110100000000010001100010101100111100000010110001101011
00000000010001001000010100100110101000111010001000000000000000110100001100010001001100101111000100010
00010000011100000000100101110000000010010000000001000000010000001110100001101000000000011100001011000
00110111000010111100001001000000100110000000001110100111000000011011100000000001001000000000100000010
01010000011000110101101000000000110000001101011000000101000001000010001100000101101001001001010000000
00000001000101000001110110000000000000001010011000000010000000111000000000001001001000010000101000001
01100010000001111000001010010001000010000010000000110011000010001001010000000100101001011010111000011
01011101011000000000001011000100010100001010001000000001101100010000010110000011011111011100001000000
00010000000010010011110100110111010100100001100100010000100000010001101000000001010000000110100000000
00001000010000100110001101100110100100000001001001110001000101000100000011000000101010011000101000110
01010110010000000010001000100000100001000000100001000000100100100000100001000100000100000000000000000
01010100010010000011110111101011100000000100000001001010000010100110001100100101000100001001001111011
01010010010111000100000000000010001000000011000100001000111001001001000001100000100100000000000000110
00001001111110100000001011101000011111010011000011100010000100000010000100010010010101010000000100011
00000000101000010100100010000001011111001011000101000001000110000100000100110100000101010000000110010
00000001001100111001000000001011101101111010001001100000000000000000100100100100001100000000001110000
00100000001001000011000100000010010000000100000000000001000110100000000000010000001010000000100001000
01000001011100000011100010000100000000001100110100000101000000100010010001100100011100001000010000010
01100000000010110001000100000000001100110000001011101000000010101000101101000101000000010010000001000
11000000000000001000110110011000010100000110100100100101010011100000000010000110001000101110000000110
01001000010011101001000011000001010100000010010100001000000010000001000000000110010000000000111000001
10001011000110001001010010000010000000101000000000010100001000000000000000100100001001001011000000010
00100000001011011100101001100000000000001100111000010000011001010000001010000001010100001000000100000
10110010000000010000000000101010100001011001011011000110010000010001010000100111001000101001100100000
10001100110001001000100000000000000000110100000000010001000000111100011000101011001001100010000001000
10100101000100000000000100100011111011010101110000100000000010000001110001000110101111110010000010100
00000100010000000111000001110001000001010100001101100001000111100000001100101010010000000000000000000
11010101010000001000101100100000100000001000000000001110000101010000011011011001100100011001000011100