43,97
84,66
11100101110000111001000011011011100011000010000100100011010000001000111100100000100000010100001100001
10000000010100101000110111000000000000001100000001000001100000000000000010001000000000100010010011100
00001110100000001010100111101000100001000000100101010100000000000000000100110000000100101101010100110
10110011000110001001001100000011110001001000100011010010000000001000000001000010000000000101101100000
00011101000001000000000000011001010100010001001000000000001101000110100000100011010001001001000101000
00100000010100010100101100010010010101000000010001100110010100100100100000001000001110101000000000000
00011000100100111000001010010100000100000000011100011001000010011010011110001010000100011101000000000
00000010000100111000101010111000000000001000100010011000000000100100100001001110100001000001100000001
01110001000010000110000110011100000000010010010000100100111111010011000000000000111110000010000000000
00000000000000001000000000000101000000000110011001000101010000011101100001010000001001100000000000010
00001000100010101100001100000000010000101011001000000000100000010101001000110101111010000000000000000
00001111100000110110101110101100010001000100011010000000011110110111000111100000000000010001001110110
10010000010110000000000000000100000000101110010000000100100000101010000111001100010010001101010000000
10000000001010010000100100100000000010000011100000000011000001100010100100010000000011110010000010110
00110000100001001000000010010010100011000001010101111010001010001010010000100100100000000000000000010
00100110001001000001011000101000001000000000000100011110000101000101000010111110100010010100000010000
00000000101100010000010000001010000000000000010000010100000000000110000000100000001000000000110101101
00010010010111001010001000101110100110000101000100011001010100100001100001100101010100101010010100010
10100000011000000110100000000001010000101000100000000100010101100000011100000010000000000000000100010
10010000010000100000010111000011001000000010000100000010010000001110000100000011110100001100000011101
11010000010100000000011100110000001011010001110000000000100010001000000000000011000100010100001011010
10000100000011001000001000101000100010011100000010001010000100000011100101001000000010111100101100010
10101100000001000110110011000000100000001001010100100100000010111001101111001000100000000000101011000
00110100001000001000000000011100101000001100100101011011100000000000000000010010010011100010000001000
01101011001010000001100000101000110100010000110000000000000010000001000010000100000100010100011010101
01100001010001000000100110000010000110000010000011001001010001100000111100001000111000101001100000001
00010000101000001100100000000000010110011100000000001100000100001000000001111100001110000001001000001
11000100000100111101001000010100000000000100100000100100111110101000000111000000111000100011000010110
00000100000000010100100100000101000010000000000100100111000000000001001010100100010000100000011110100
00010010000001101010000000001000101001100000001000010001100010000110000000010001000010011100000010000
00010000000000110001000001011100000000100100010000000001101110000111000100100111000110001010100110001
01011010100111110001101000011000000001001101111010110010100100001100100110100100000110001111000010000
00001011010000001101000000001000100010000001000001010000101110100001000010100010110100100000000000110
11011100000100000100110000110100010001110000110100001000000000000001000110001010101000100000110111100
01000010000000010011000000000011110110010111001100100000100100010000100001000010000000100000010000000
01111001010100000100010110000000000010000001100000100110010011010110010100110011011000000100110100000
00000010100100000000101010000010000010000110011010010000000001000101010100011010000000110110110000011
00101000100000001101100001000100000001110000111100000110111010100000110000000000000000100110100010001
00000101110011001011001011000000000000001000000101100000100010101001000011100000010011000100000000101
00100000000000000000100011010010011010110011000000000001100101000000010101100100000000100100000001100
11010001110000100001010111000010001001111011010101000000001100010011110101001010100011000100001010100
10110000010010000000000011010001010011010110110001001000010101110001000000000010000000101000111100111
01000110011100000000100011000001001001000000000010000000000110100001010001000001011000011011000010001
10000010110001100111010001100010100010010000001000100000000010011110000011000010000110001000000110000
00001100001110100010010110001011100010000110100100110110001100000101001001000111000110010001000000000
00000010101001001000111000000101010100000010010101000000000101010010111001000110010000000101011110001
11010001001010010000000010000101000001001000000010000000001101110000001110000000001001100100100101110
00000001000101011011010110000000001101000000100010010101011001011000000110000000001001010001101101010
00010000000001110100000110001110000000110000010000000100000100100010000000000110100000000000100100101
00010011001001000011010100010010100100000100100001111011100010010000110000001110000000100100000000000
00000000000000010100100001010101011000000101101101100101000001100000110000011000010000110100000011000
00000000011000000000100110000100010000000001100000000100001101100000000011000001100101000000000100010
00011110000001100110001000100010101001000000000000111000111001110000101001100100011000010101101000000
00110010100001001001000101010000110010000000000010110010011000000110000001010011001000100000000000010
11000010000001001010000000011101100100100001000101111000011110001011101000000100000010000000000100000
01001010010101010100000000000101011110000001000011001111000000000000100101000000000000110000000000000
00001000011001001001110011000000001000000010011000100001100100101000001010000010000010001101001000011
00000110001001110111100000000000000001000110100011000100010110001010001100000001110010101000100110000
11110101010110110000010000001101110010001110010000000110001000101001100001000100001110000001100000010
01000010000010101001110001111110001001000100010010001010000011011000100000101010000110010000001000100
01010001100000000001001011000010001000010010100000101000000010010010001100000000000100110001010100101
00011100001100100100101100010000111000000011111110110000100000011110000010000101010110000000100100100
01010000000010001001010000000001100100100111001010000010000101111100000100001000101000001000001000110
11001000000101001110010000100010000101000000101100000001000000011000000110011100010110110100000000000
10110110000010000001000000000000110000001100110100000001110101010000000000000001101101110000000100100
00001101000110001101000000001000000000001000011100010001000000101110110001011000000011100001110110000
00000000000110111100001001001010001101010001000110000000000001100100010000010001010000000100001000001
00100001000000010000110101100110000000010001000111010011110001000000000000000010010100000100001000000
00010001011100100001001001010110001110000100010111001001101001010101101000000000000000100000101000101
10100000000101100110000100000000000000011000000100000101000101000000010010000110100011110101000000000
00000010101010000000001100100010100110111001010111000000110010111001011100001000000000100010010000011
00010001100100000000000111011100010000110100101100100010101001000001000001001000100001111100001100000
00011001010001001000100010011001000001000000100101011100000000001100000100001100000000101001000000010
00100000100011110000000101000001100010010001000011111011000010011010010100010000010100000000000000000
00011000000000100010000010100100000000010000000100000000100101110000111000100000010000111100000111001
10001000011110000110000010010101010101100001101000001100011011110000100100010100101000000000001100000
00100110100000000001001001010000001000000000100110110001011111101000000000111000110011011000000100011
00111000001100001100100010000010100000100100011010000100100001101001101010100000001001000100011000100
00100001000100101001100100000100010000010000101000000000010000001000000000001010000001001101100011000
01010000000101001000000011100000000111010000000010011000011110101010110000100000000011100100000110101
00001011001111001001000011000000010000001101001000101101000100000110010010100000101000100110001101000
00000010001000111000111000101000000001110101010000101110111000000010001001001000110100011101010000000
00001101001000001010000110011000101000100001000010001010110001001100010010001100000010000100010001010
01001010110100111000000000011000100000011000001100000001001010101101011100000000001101000000101101000
00000000111000000001000100001010000011000010001000100010001010100001010000100111010000001000011001001
00100100000000000000010010000010100110110000111000000100000010111000010001001001000110000000000000001
00001000011110001011011000010100110010000000000000110100010110001100000000101000000000011011000000000
00010111000000000001000100001101001100101010001001000100100100000011010001000100000010100101010010000
01000000000000110000010100101010001100110110100001101000000000111000001001001010100001100110001000000
00100000010011001000000000111010100110010010101000001001000000010110110100111110001010010000010000010
01000001001000000000001000010101100010000000010001000010010000100001010010000010000011000000010000101
01110111100000000101010011110000000010000000000111010000011000000010011000100100001000010000000110010
11011001001010001100010001000000000000011001010100000100001101010010101010100100000010100000100000000
00001000000101000011110000000000000000011001000011010001110100010111000010110100001100001000010010000
10100001000000010010000000000010000100000010100011000000001010000111010010101101111010100000110010001
11010000100100000010110000000000100010010000100001000001100001001001100000011000000101000001100100100
01010100011101000010010110101000111010100000000000000111110101000010001000010000100000001100001000100
11001111001000001001010100000001000100001110000110000110000001110010010000000000100000100001011001000
00100100100011000010111011011100010100101001000000000010100100100101101100111001000111000100001000001
01000000010000000000000001000110001100001100010101100001000110001100001000000001001000001111001110001
00000000000100000111011000000100001010011111000100111001100110010100000000000011100011101000001111010