50,62
94,2
00011100000110100010001000000100100001100011001100000100001000010000000101000010001001101000010000000
00110100100011000001001010000001101010001010000111000101000010000110000011100000001101000001100100001
01101000000000110010100010000010000010001000001100010000001000001100000000111000000110000010101010000
00110010010010011000000000110100000000100000100001001100110100001100000000011001101100100001000001100
10100000000100000000111010010111000000110000111010000000000001000110010111110010000101000001000000000
01010100000011010101001010001011000011001010110001011011000001001000010001000011010101101010000110000
01000010000000010100101100000100011000011001011011001000000000110000010111100000000001000000010110100
01000001010100001010010001000011000011011100110000010011010010000011000001010010000010000010110010000
01100000010100100010100010011000100001000000000010000000100000101101110001100100010001000011001110010
01000100000010010000001000000000010100000000111110100010001101000110001001000100101011100001000000010
00011000000001001000001001100001000000010100100010000100100000000010001001100000110100100000000000001
00000000000110100101001010100010000000000011100000000100100000000000101010000000000001001000100010011
10100000110010000010000010100011111010000100011010100110010010001100100100100100001001001000010001110
00110000000010101001100100001011010000010000100000101000010001010001100100100000100110001011000100000
00000100100100001010100100010101000110100001100000000010011010000100100100101100110010100101111001001
01100010100000000010001000000010000010000000000001011000000000110101010000000100001001010101010000000
01111001110010000110110100010011000000001001000100100101000001100111000011101100011100100100100000001
00000100001011100100011110010100010000100101000001000001000011000010000000000000010110111000010010000
00100100010100110001000000000101000001010011000100000000010010010010101001101000110010110000101000000
01000100000000010100100100010000101100100001001000011000000001110000011000000100111110100001100011000
00000000110000001001110100010010010010000101011000110000100010100101011100010100000100001110010000000
00010000000000000011000100010000000010000000111000001011001010110010000010100100001001100000101110011
11000000011000010010000101001100000000000101000100100101001101011100001000100000010000011001000010000
01111000000000100001110101000000100100001011100010011001000000000001000000010010000001100010010100000
00000000010001001100000001110001011000111000001010111000100100010000001111000000100000001101010011000
10010100110011000100100110000010100000110100011000101000010000111001011000000111101101000000100110100
01100010010010000010001000100100110000001000100000001000001111010101000001000000010110000001000001101
11000011011001001000100000011100110000000000000001000000000000000000000000000001000000000100001000011
00110010000001001101010010110000111000000010010110000000000011110001100100000011000000011100011110000
11100000100000010011100000000000001100111000000100011001101000001110010000000001000000100010000011010
00101101011001000100110100000100010111110001001000101000101100000001100010010010010001001110010110100
01000000000100011000010111000100000110000000000000101001100000010100011100000000001100110000000010100
01011000010010011000100100010110100000110101000010010010100101000100110000110101100100010100010000101
10000110001001010100101100110001001011010000101000100001000010001000000110010000001000001001000100100
11100110000000000011111100000000000011001000000000111101011000000000101000010010010110100101100001011
00110001000100100101000100000011101010000100100010001100000100000000100110011000000001001000001000110
00001000100100100001010101100111001000011001000000000010000001010101011001000100000001000111110101000
01010110000000000000110100011000110011010000001000100000000010100011110111101100011000100100110000000
10010000000001100000001000001010100000000110000000011110001000000100000000001001000001110001010101000
01110000001000110100000101000000100010000000110011000000111010000100110001101100100110000001000110011
00001000000000000001000010001001011000110000000101000010111000000011010000010010000000000000000000000
00100000010100011100011111000000001101100110000001000100010001010110100010001101000000000000000001001
00011100101010001000001100100100101001010111100000001001000110000000010101000001101000010011111001010
01101010101001001100010101101000000010000000101011011101001100010011000000010100000100011000000101000
10100011000100010010000010010000101011001001101000001000100001000010000101000011100101001000101100000
01000001100000000011010000010100010101000110100000111001000111000010000000001010001110000000100100001
00001000100001000000000000000100001100010000111001010010100010000000000000001001101000110000010000100
10010111010100110001100000110110100110010110000110101010010000010100100010111110001100001100100001000
01000100100011000100011100000000010100010011001000100001001000100000000000010100011000000010100010000
10000010000000000110110011110110000000010000000111000011010010101001010010000001000100100010101010101
11110000100000010010000000100100011001100111110001000000110000010110000000100100101000000000000001010
01000100010000100000001101100000101000010001000100100000001000010010101000010000001011100010010010000
01101011101010100101000001000001101001000100000100011000110000011001100010000000010101100010000000001
00000000100001011101000000001001000010100010110000101001011000000010100100101010001001000101001101000
00000100000110101100100000001010001110010000000000111010100011000000000000010100000000000000000000000
00100100001101000000000000001000010011000100111010010000010011000010100001000000010010010010011000000
00001000000100000010011100110000011010000010010100101000001010101000100011100000010000000000000000100
00011010010100100000010000001011100011101101001010011110000000000100000010000000010000000000100001000
00100000000010000010111001000000110100000000010000101001001100000011010011000100000010001000000010010
00010010001110111010000100100000000111000000000000001010001100110000000000011100000010101000010000101
10010000000010101001000010101000111000000011001100110010001000100100001110001111001001000010000000000
01000000001000100000010000010101000100000000100110100010000101000001011000000000001010010000011010010
00010000000100000000110010101110100000000100010000100000011011001100000001010000000000110000001001000
10010000100110001111010010111000010000000000101100010000000011000000000100001000001101100101100000011
00011101010000000000100101011000010011110000100010001111001100110100101001001001011000100000010010100
00001000110101000110010110100000010000010010000000000001001000100011101000000000010001011000010000000
01000101110010110000000011000110011000100000100011011001100100000000101000001001111101000100000001001
00100011000010000000010000011100100100000010000010000110010001000011011000010001011110000000010001010
00010101101100001100010000000000001111000110011110000010000011000101110011000100111011010101000000011
00000000100100110011000110000001100100000010000101000100001011000110100100000001100101111010000100010
10010001000100000101001100000000100111111000000000010010001010100000010001010010000000011000000001100
00000010000000100010001000110001111101010100100000100001100000010111001100101000001000000001000000010
01001010011010000011001100000100000000101000000001001001011000100000000101000001111110110000011000000
00010110000010011001001111000001000001010000000000001011000010000010000000010100000010000000010000101
01010000000001110000000001100010110100001000000001110001010000010100000000000010000000000000111001110
00010100011001100001010010000000001101000000001000110001110010000000101101000100100111101100010000000
00010000000001000000001110100010000100000000100000101100000000000000000000100100000000101000110110100
01100001000000011000001000000000101000001011001101100001111001010000001010100000101110001000010100000
00010100010010000100101010000000101000010101000000001100000000010101001100000110000100000010011100000
00011110011000101000101000001000010101111000010000101010000001000010000000001100101000110010000001101
10000010110101110000000100010001010000000001000010100010000100000000000001110000000010000010110001001
00110001001001000000000010011000000001000011010010001000000000010001000001000001000010000010001000111
00110111100100000100111101100000010000111010100000100100000000010100000101000000100110000000101010000
00000010010100000010110000001000011000000110000100000100001110000100001100010000010001001000000000100
10101000000000001101110100100000010001000001100110010010000011001000000000100111000000100000001101111
01000010000001100011011101010010001001000101000100010000000010011010000010110000010000000100100111000
10101000000100100011000110011110100010010001000010010100000001011100110100000010010110010001001011101
11010000000000001000010010010000000100100000011010001110110000010010010101110100010000000000100010111
00000001001100000000000100111010000000010001000000000100000100100001001000001101100100000000000011000
00100000000010011000000010000001000001001000001000010100110100110001000100001001000000000110111001000
00000000000001000011000100000001101011110010011100010000100100110000000000011000000001001001000100100
00010001100000001100000000001110010011110000010110100000000010100100001010110100010000000010100000000
11011000000100010100000000110101100011000000000000111001110000000000000010000000100000100001000001100
01000000000000000101000000010110010000100001110000100000000001001010100100000100000010001000000110000
11000001000000000101010100000100000000010011001000000000001000000100000010100000000010000000100001011
10100101101010000110000010101000111001100001000111001100011010001100010111000000000000101111100010000
01001100000001010110100000100000011110000001100000000100110001011110010110101011100001010100000000000
00000010110010010100101000011000000000100010000001001111010001110100000100000000000001000111101101110
00100001010000000001001101100101001100001100000011010010100100000010010100000111011100000111010110101
11001000001001001000000100010000010000000001000001011100110001000100000001000000101100010000101010000
00100000101010000100001110100100101000000100010010100000010010001000110000000001100000001000010010100