33,62
78,41
01101001111000011000001010100000010000000000100000111110100101010001111100011000101100000010010010000
00111011100010010100100000100011000000000101000000000100010000001000000010110000001010100000000000001
10000110001111100000110000001000010000000110000100000111100000100001110010011010000010010101100000000
01000000001101100111010110111100110010110001000010000001000011100001100111000000110100101000100000100
01010010000000010000100011000000000100010110001000100011000001110010010001000000001010010000100011000
10000000001000000001010111000101000101110001010000100101001100010000100100110010100000000100110110001
00010000010010000100101010100010010011000100100110110100000100000000001100111000011001100101100100000
10001010001000000100001000101000001010100000001010010101110001010100100001000011010010000011000110000
01010010000000111111100100001000000000000010000000011000000110001010010000000010110001000100000001000
10001100100100100000001000001100001001100010100100101000000010000000100101010100001100010100000000000
00000010000010000010111100001011000001000100101001110000100001101111100011000110000110110000011000011
01000011100100000010000100010001010000011100000000000000110110010000011000000100000011101001100000000
00000011000000000110101000000111101010110000000100001000000001100100001101001010100111000000010000010
00100000100000000010111000010100000100001011000010110001010000110000000000010000011001010100000000010
00010000100000000000010000000000100000000001000001001001100000001010010000001110000110000000000010001
01011001010001101100000100001000010101101101000101000000101000110101100000000000001000011000010001001
10111100000000100000000000100100100010001000001010000101110001010101100011001100001000110000011010000
00001101000100010100010100100100000100010000000010011000010001010000110010011101011001000010101000110
00001111010000011001100000000011100010100000000101000000010001000010000000110100100010110100001100001
00000101100000100000101000101110000000101001010000101001110000010100101000010001010000010111101000000
01010100101000010100000100101001000101010101001010011000000000000000000101000110011100001000000001001
00101100010000001110000001010010000100100100010000100001111000000011000000000101100010001010010001011
11100100100010000100011100000000000000000100111110100110001010100110010100010100100101110000000011000
00000100000010000111001001101010000000000100001000010011010000110110000000010000010001011110001100110
00000000101001110100010000010001000000110001110100000000000000110000010000101011000110000010000100111
01000100011111000000100110000000100010001000000100001101110011010100000000110110000100110001000000000
01011001010100000010001010000000010000010000000011101000001010011100110000100001001001100010000100000
00000000010000101010000100010110000111010000000100000001001000000000010110000000000100000000011000001
00001010011100001010010000000000101110001111010111000001000000000101000100001000000001000101010000010
00000000000010101100100000001100100000001111111011011000100010110010110000000010010000110001110100001
00000011001000001001000000000000000100010010000001001011110100000101000100010000000000000000000100000
01100100000000000000011000000001110001100011100100101001000000011001110011000100111111001000001000001
01000100010000011001100010101100000010101010000100000000000000110010001001001001001000001011011101100
01100110010001000000000011010000000011100000000000000001010010001100100010010111000000100100110000011
01110010001100000000010100000001100111001001000101000000001010011110000100001011000110100000100001001
00110000001100000001001000100001000101000011011001111110000000000010011000010000100010001001001011000
00000001010100000110010000100000110000000000100011001001100000100000001000110100100001010000100001110
01000000000001100000100100011100000000000000011101011101000010001011100001011110011000001000101001000
10011000100101110001010010000100100000111001001010000010000000000001100100101011000100000100001100001
00010100101011001000011000000100101100001011010011000010101000111000001010011010010101111101010000100
00010100001000000010000100000110100010010100000001011000000100101101001100010111111011110101001000000
00110100110011001001001110000001000001100000000000111000010001101001001001000000000001100000100001000
00110000000000010101010000000000001000100101000001110001100000000000100100110000000000000000101001101
00100010001100101011000000000000110001101010011010000001110010110001110100110100111000001000000000101
01000100010011000000000000010000100000000100100001010000000000010001101100000000100101000100010001001
10000000000000000010001100100110010111000001000000001010001110000001000001011010011000000000101011101
00011000000000010010100000001001110001011101000001000001100000010001001010100011100000011001001000000
00001101100000011010011100001011100010011001000111110100000000100000110100001000100100001001100011000
01001001100000001110000000000000010000000000010000001000000110000001101100000000010010011001001000111
00000000000110000100000000001000111000001010011000100110010100100010100000100000010110100101010000011
10010100110000101000000000000001010100100101000111000000010000000011000000011000000001000001010100000
00100100100000011100100100000110100110000101000000100010000100011001000000000010000100101011010101000
11010000010000110001000001000010100111101100000011011010000000000100000010001110000010011010001110001
11000100101010101001100001011000000100001000000000010000100100000000000000011110000100000100000100110
01001100001100000010001000000010000000100000110010001001101101111001010000000000010110100000101110000
11000011000010110010100101000000101110000000010000000101001100100110101010000100000001000110000000100
00001110001110010001000001000000100010101000001010000100011000010010000010011010000000000100010001000
01000000101001100000010000110001001101100101000000011011011010000001011010101001011100001010000010001
00010000100000000010001010000101001001101110001011000011011000001000010001000011100001000101111000100
00001000100000001001000001101010000000100100100010110000000100010100001010000000100101000010000010000
00001010000000000111000100001100010000010010010100001000010100000000000001001001010000000011100011010
11010000001100111000001000000000110010010000000000110000001010110100100100111000001001100010101010000
10010000011001011000100111000100010011001000110001001100000000000001101101000000001000001010010001110
00010000100000100000000000111001100000010101101001111011001000001001101001010000011110010101010000100
00011000010000000000010000000001000001100101010010000001000100010101000001100000110000001000100011111
11000101000010001000000000101000100010000100000001100011001110110100010011000000001000000000100000100
01011010001000001000100010000110110000001111000100100100010011000000010100011000010010100000100000110
00000000100100000001000000001110000100001100011100000010001010010000010000000010001001110001101011000
01111000000001111001101100100010100010100011001010010000000010001010000111000001100101000101000100000
00001110100000011100101100000001001001001001100010100001001101000010111000011001011000100010100000100
01000011000100000000010000100000010000001000010000011101000000001100101001100000010000101001011000001
10010010010111100000000010000010100011110010000001001100001010011100000001001011100000001001000010010
00100100000010110110110100100100100110101101000010010010100001000100001000011111001010000000100010110
00000000000010000000011100000001100000000011001000011111100110000100000011010001000011001010001101010
01101101000100000001100100000000111010110000011101011110101110100001100001110011100001000000110000001
01100011000000001101000001000100000000000001000011011000000011011000100000000010010000000010101000010
01010001100000000010101111001111000000011001101111000010100010100000000100100000000010010100000000000
10000111100000010111010101010000000110100000000011000000010001010001010100000111110000000010100010011
00001010111000000000100110010100000000010100010001100000100010010000100101000100000001000110000011000
00110101001100010000100100110010010010100010001010100011100010001111000101100000011000000000000000010
10000110100010100000010100001110110100000000110000101110010010101000110100001111001100001000001110011
11010011010100100000010001100001001100110010110000010100100000100100110010000011000000000000010001110
00000011100010101000001110000100001001000001010000001010110100000111100001101110001100000111000000001
00011001000000110100001001100011101011011110000110000100001000000010110100000000100100000100100000010
10001011100000000000000000110110000011101001001000000000000000001001000000001000110000100001000100000
10000010000000001000010000110100010100010100000100010000101110100000011100010001000011100000001101111
01011101110000111010010000100100000101000000010100010110010000000011010000011010000000000010001111000
10011100000101010100000000011101000000010000100110110101101001010110000101110001001110100011011000010
00010000100111001100000000000011010111011010100001111000000100100000010100010010000011010000100100101
10100000000000001000000000000101001100000001001100100111010010000100001010100010001000011000001101000
10101000110100110101010011111010001000000001000010000101000000110000011101011000100001100000000101000
00110100010001001000010001101000010100001011100110000101001011000000010000010000001000000001010100111
00101100000100011011001000000010100001100010001010000010001000000100100100001000001000000110101011001
11000000000000000110000000000110010100000000000011000000000100000101011001110001001100001100010110011
00000100010110100000100001001101000000000011010111000000110001100101000001000000100010000010100000011
10110100000001011000010101011001101101001001000000100010000100000000001000110000100110000001101101000
01000000000110000000101010000000101100010011000100001101001110100000000000010000101111011000011000011
10000001000100000000000000010000010010001100010000001000101001000110110100100001010000000010011111001
00100010110010000000110001000001101001000001000010001010000001011100000000000000000010111000110100001
00000000010000001001000100100000000110000000000001010000001100001000000001010001100100111000100101010
01011011100001011000111101000010100100000010101000000001111100000100000001000011111101000000010110001