56,38
48,30
00000110000001000010001000001101010001001000000100000000001000000000100000010100010001101000000000011
00000000000010000000010010100011000000101000000000100011000100010000000000001011111010000010011010000
00101000001010000100000001101100100000100001000100010010100101101000001101110100001010101001010011010
01000000001000001011011100000110101101010011010100001001100000000000011100010000010100011110000000111
00100011011011000011010100000000010011100100010010010010001100001011000010000010001100001000010001010
00010010100001100000010000011011000100010100101000010001000101000111100100010000000000101110111000000
01001100101101000011011000010000100000011000001011001011010000000001110000000100000101000000000011011
00011000111001100001000001010100000011001111000010100000100011000010100010001001001001000000100101000
11100100010010000100000010000010000001011000100111100000000000000011100110110011010001110011000001000
10110100101000011011110001001000010100000010101001001000001001101000110010000010000010100000000010001
01100010000101100000001001100001001000000000101010000001000010010111000000100000010001100001011000001
10000011000000010000111010001001000000000011010001000100011000000000000000011010101001010100100100001
11110100010001101000001100100000001001000111001001000001101000010010001000010011000100100000010000000
00000110011110000000000110001000000000101010000001010101110000010010000000001000000000000000001010010
00110100000111010010010100001000001001000000000011000000111011000100000110110000010000000001000101100
00010000000110001000000011000101000000001110000000001011100010101001100001000000010000001000010001100
00001010101000000001010000010010010001010000110101100001000100000100000000100000100011110011100010001
10001000000100000000110100000000100101000000000000000000001001000001000110100100101100000000101011001
01100100000110110000000010010010110010010000000011001111010000010111000000000100111000001001110000001
00000100010001000001110001000000101110111000000001000001001000000010100000011000000101001000010101011
00110010000000101010101001110011000010000000000010010000100000100010000100011001010100100100101000011
01100100001000010001010000011000000100000100101000000000000000000100000001001100000000100001000100000
01110000000100000000010011000001010000000101000100001100110010100001000101001000001010011001010011000
10010100000000010000100010101011001010001000010001010101100001000100000000001000110000010011000111001
01011101000011001001001000000100000101110010101001100100000101000010000111101000011100100000000001001
00000101011000000000000001000001010010110001110000001010010101010100101000100000000101001000100001001
01000100001010000100100100010001101110001000000101000001010000000000001000010001010100010011100010001
10000001010101001100001100001000000010100000000011100011000001010010000001100010010010110010000001000
10100011000000101010001010100010011101011100110011011000000111001010000000100101001010010001000000100
01000100110111000101000001100110100000100100001000010100001011000101100011001001000000010100000000001
00010110110000100011000000111001100010000101000001101110000001000010010001111100001100001011100000000
01000000000000100110101010000011110000001000100010110101010001010100001001000000111001001000001010000
00001001001101101010000001100000000100000000001000100010010100001000000000000101010001100000000000101
11101010110100000100100011001000000001101101010011111010001100100000100010000100001010011010001000001
00000100000000000010000000100001000110000000010100000000100010100011000010111110000000001001000111110
00000001100100110010000110100000111000000000000101000000010000000010010001000001110000000000001100101
00100010000000110000000001001011100001101000000000001010000000100000001001000100010010001000100000000
00001000100101000000100100000101101101000000110001110000000001001100011111000000011010001110000111001
01000100011110010100000100010000000111100010100001000000000010000001010010000000010000010001010001111
11000000101010000000101110111010000010000100100011000111100001010000000100000000011110000101001101000
00000100010000000010000101000001001100100001110000100010000000110000100001001000001001100000001010000
00000100010111000111000001010000000101001001000101110000110000000101000000010000000000001011001000101
00100001000000010101001010010001010100100000011001101000110011001110001110100000000000000000000010000
01010010000000101100000010001100011011011000001000001110001001100000000000000101011000001100001000011
00000100101001000000000001010000000100000001001001100001100100010001000001000000010110000001100011000
00101000100000000000010000100000001000100110100000011011010000101100010101110000001011000010110000100
00100000000010001000100110011000000100000000000001101100000000000011101000000000100101000000001011110
10110100010001000001101010011010000100010000110101010100110000000010001110010100000100010000010011100
00010000000100110110110010011000010000000000000000011001000100101000000000100100001000010000010010011
10000010001000100100010011010010100011100101001010000000110001000110000001101110100100011110010101000
00000000000010000001110010000100100100000000001101000100100010000011000010100001000011110001010101000
01000001000001000100100000101100000000000000010000011001100000010100011001000101100001010001000010000
00001010000000100111110100100001010100001011000010010011000001010110000000000000001001011011011000100
00101100000010000100100001000001000100100000000100000110000100100001100100000010010010000100000001001
00000001010000000001001110001001001000000010010001000000010000101000100100100010100001110000010001110
00000000000101000000000001000010001001100000000010110000101000100100100001101000001000000000000000100
00000000010100000000100000000010110000001111011100001100000010110100000110000010000000001001001111011
00010000011000100000001000001000100000100000010100010101000100011111010000000000101000010000110100010
00000010110100000010000001001001000000001100110000010010100100001010100010000001010110011100000000011
00010010000001000010011010101100000010011001010000001001010110010010010100001001000000001001000100000
01001000010100001001001001000000000011011010000100001100000111010110010000000011010000000010000001111
00100001000010001100010000110000001000000011000011110101000000011000010000110010001001000011100000000
10000000000100000100000010101000110010000011010011100010001010010011000000010000011001000001010011100
01000100100001000000011001001100111010101010100010010000110001001001111010001100100111000010000000000
01000000000000100100011001010001000110010000010010010111001000100000100000110000000011000110100000000
11000000000010000000000000010000101000101110100110100110010000100000010100000000111100000010001000000
00111010000011001001000110100011100000000111110110000000100000010000000101011011000000011000001010001
10110101000111011100001000101010100000001001010001000101000000100101100100011000001101000100000000101
10000001011111011110000000000100000011000001100001001000000001000010101001100101110000010100001001011
01000100100000000100000010100110000101011000001000000000100110100010110100011110000011000001000001001
00100010010011010101000000010010010010000010010001110000010111000000000000100110000000001001101000000
00011010101010100000000110010100110100000001001100100010000010101101100110000100001110001000000110000
00101001011000000100111000000110000100000010000000000010110000100100010001000100100010100010000010100
10000100001000000001000000011000010110000000101101100000000001001001010000101101111010110011000000000
10001101010010000000010011000010100000000000111001110000100000110111011100010000000010100000000010000
10000011010100101000010100010000010000000000001101000000011011000001000010011010011100100111100001000
01000010100000011010100000000010001100010000011001000101000000100110000100001000001000001010010010000
10000100110000000001001000000111111111001011001000000001000010000010011110010100100100000011000000000
00001001001001110001110100000001000001100010010001000110010001100011001000101001001110010100010101101
01100000001000110001000100010010001010100001110001010111101100001000110000010000001000100000101110001
10011010001100001110000000001000100111010001110011000000000000000010100001100111100000000100000010000
11000111000100000010110010101001100000000110100111110100101000010001000000101001010000010000010010001
01000000101000011000010010010100001000000000000001011010000001010111001010110100000010111110101000000
10001010111000010110100010011100011000000000000000000011000110000000010000000000110000010000010010010
00100100000111100000100010001000101000000001000111100000000100000000000000000101000011000010010000000
10100000000010011100000100110000000111000001100010001011001001000100000010100000001110110000000000100
10010110000000000001010001000110010100000101000100000001000001111101000010010101111000100010010000000
10001001000010000100000001100000101000100000011101100000000100010000101001100000110001001001000000001
10010100110010101011100011001101000010101010011110000100000110000001101010000000000110101010000010000
00011001001011001001000000000011000101000010000010000000110000000001100001000010001000000000001000000
00110100000000000100100100110000010100010110000100000001000100100101011100000000000100100000001000001
11011000000100010010000001010001010000110000010001111001101100011000010101000000010000101000011011010
00000000000000000110111010001000100000100000110100000100001000111111101000010010010011100000110010101
00010110001110010000000000011101010100010010101000100100000000011001100010010001111100000000100101011
00000000100001000100110111000001101011010000001001000000010011110100000000100000000000101100000001100
00000010010010010000110000010011001001010010100001110000100000000000010100110000000000010101000100000
00000000000001111101101011000000100001001100000000001010000010000100010001010100011000010001110000001
00111000000100001101010010001001000001010100110100010100101100100100111000100000001000110001100001001
00001010011010011110000010010100001011100001101000100000000000000001000010010110000000011001100001010
01000000100100000011000010011110010100011001101000000011000000000010000100000110000100000110101001000
10001000000110100000010001100001111001101000001110000111001000000001000011001100100000010000000101000