66,87
85,45
10000001000010010100000100101100001000000101001000100000101001111011001110000000001100000100010010000
00111100110111001010101100100100010100001011100010001001001001111010100000010000000000100000001000000
00100010101000001001000010010010000010000000000110010100101011010000101000110000000000000010001101010
00101010101000101000100000001010000100000001100010111000001000000101000001100100100100000000001001110
11010001000000000011000110101001100111111100110000010111100000001011010100101100001001100010001000100
00001001000011001000000001010010000100001101000000100000010111100011011000000000001100010011011000001
00000010001001000110000001000111000101000000100110010000000001011010100100000000000101001000011001110
10010000000111000000110001000000101000101000010001110010000000100010000001001000101100000100001000011
10110000001000000000110000100110001010000000011000111100001000001000001110100000000000000010000011100
11100100011100010100001001001001100011100000000000001110000000000000000001000000000010010000100100000
10000010000011100000000001000010100100000001001100001010100001010000001000100001100000000000001110000
11001000110010001001001000010010001101110100001000000100000000010000000110000000000000100010000100001
00011110100001100000000011001101100000000000100111000010000000110001000000010101100000000010100010100
11001000100111000000000000000110100000010011011000000101100101000000110001000000100010101110011011110
00001000110000001000101010000110000010001000000110000001011001110110010000110011001001000000101111001
00001000001000001000000001000001000110010000000011110000111000100001000101100100000000000110000010010
00001000101100010010111011001111110011011011100010101010010100100100000000000100010010100000101000000
11100000100010001000000001000001010011000000101010010000001100100001100010100100000000000010010000011
00110111000111100000000110010110001010000001000110011001000111000000000101010100100011001000100100010
01001000100100001001001010110010010000000000010010000000000000110000001001000010100101100000001101000
00110111100000000101001111001001011000100100000010100000000000001000011000011010011000100100011000100
10001010100001011000100100000001100000100000100010111000101000000000111001100100000001101011000001010
01000011001000000000101000000000001100000000010000000000000010010110010010000001010110000110101001001
01010011000100000101101100100110000000000000000100101001110011001110100100001001000000000001000000100
01100001000010010100001010000110000001000010001000000000010000100001011010100000001001001010010001001
00100000101000011110000000010010111000001100000010010000110001010000100010011000110000000010000000110
00000001001100110100000000000000010000001011011101000000100000100000101000001001001011000010001001110
00110100001001100010010000000000001010101011000000000000001000000000001011011010110010011110000011010
10000000000011010001001011111000001001100000001010001001100000000000011100001100010001010011001000000
00000101010101011010101000101100011100000100000110111100100111000000010100110011000011010010100011110
01110001000000100001100010000010101011000000100001101010100101101101010101100111100000100000000001111
10000000000001110010100010111000011101100000000001000110000010000001110000010110000101000001000111110
01000001100101110111110000000100000111001001010010100010010011100000011001100000100011000000010100001
00000100101010100101100010011010010010000000001010001110100000110001010000000001110000000011000100001
00000001000000010100000001000000011100000101110100001000100000000001100000110110110010100000100010010
00100010110011000011000001000101100000000100100000101000000000010101000001110010001010010010100011000
00010000010001000001000110110100010001000011000010000101000000110000100001001000001010001000110101010
11001100000010110010101011000110001011011010101000100000110101000011001000000000000100000010100000000
10101000000000001000100011101001001100100000010010011000001000000100000000100000000000000000000011100
10101001000110101011111101001111010110001010000010001010100100110001000100010101000000001010000010000
01010101000001010010100010000111000101001001001011000000100010110010000000000011100100001010000001101
11000011000001000001010000000100000000110001001000100111101000101000001011001010011001010001100010000
00001001110001111010100100110000100110000001000100000001100010000000110001110001010000000001011000000
01001000101100101011001011101000101100000000001001011000000000010000000100011010000000010100110001011
00001100110100000000000001010101011010100001100011000100101000000100101100000110000001000001000100010
00010000110000001000110101100000100110110000000010000000001000010111000010110111100111000000111000000
11001010111000000100000010101100000000010101000011010000001000001101001000010100000010101000000010001
01000010000000001110101011100000011010000000001001001101000000010001010010001110100100000011101010010
10110000110011001011010000100000000001011010001100000110110000000101000000010000000000010000100100100
00011101100000100010100011000011000000001000001010111100010000000011110000100000000010011010000000000
10000101100101010001000000011010100011100010010100111000000011011110000001100000100010110011010000000
11010000110011000110001001101000100000100010000000010000110001010001010010000100100000101000000100000
00000001101110110000100000011001010000000100000001001100000111010001000000001000000000001000011001000
00100101100000010011110011011001100000111101001000000001100111110100100000010101000000000100000000001
01010001000001101000110001101111110000001011110001000000001011010100011000001001110000011011000000001
10100100000001101010000010010000010010010000000100100001010000010110000110000000110010000011000100001
10000111000010011000101010000100101010010000010011110000001001000000001001001010000010100110010010011
01000000100010000100000100100100100001100000100001000011100100100000010000010010000011010000001110010
00000010000100100100011001001000000000010000111000111001011101000101000100000011010100100010010111000
01010101110010000000100011001000100000100111000000000100010001101001000101100100000011011000111111010
11001000010010001100000001101000000100001101100001100101011101000010000111101000001000011100010001000
01000010100000101100000100000101101001011000101101100000000100111010010000000000010100100100011101001
00000000100100000010010101101011000100000000001000000100000010010100010001110000000100100000000010000
00011000010100110000001001000011110001000000011000100001001110010111000000000001011100001001100010011
00001011110100000000000000000100000100000000000110000000000000000000010010000010100001101100001001000
10001001001010001100100000000110001010100010110111100000110001010000000000001000011011000000001101001
00010101000110010011000101100000010010000001000001001001101000000000101110000000010101000000010001010
01000111001010100010111000001111000010010100011001111000001000011000000010001010000010100011000000101
10000000011000010001010010000000001100110000000010000000100011000101110001000010001010001000000010110
01101011001001000100010100000001010001000010100111110000000111111111000011000110000001101100000010010
10010001101100010010000100110000101000100000000111001010000000100001001100000000001001001010101010011
00101100011101001110000000101101001011010000100101101011101001111000010010000001110001000010001010100
00000000100100000001000110110001000010011111110111100010010101000011001000000001000000000001111001011
10000000011100000010000011000000110000000000110000100000001000010100000000000000010001000010010000000
00000011000000010001000110100000000001100001100001100000000001001110100000000001010000010100000111010
00010100000001011001000011000100001010100101100010000101000100110000010011011000001010100000000000010
01000000110000000000000010000011100000101000001001110110100001010000001011000011000000100000001001110
00100100000001000110000100100000110010000000101100110000110101100001000000000000100010001011000110010
00000010011000000000100010010000000000000101000001010001110001011101100000001001000010110000000001011
01000000100011010100100000000010000001110000000001100000010000001100010000000000000111000000100000010
00010011010000011001000100010000011010000000100011001101101110110101000010000101000110101100110000010
10010000010010000001100110000100000100001100100101000000000101001000100000000000100010100110010000000
10000100001011010010001000100011010100000001001100001011011010000000010000000101110000001010000010110
10010010100111010101100000100000100100000000001010000100000010000010100001000000100001001101000100100
00100110100011100110010001101000110010100000000111101000100010000000101000000110110000010000010010110
00110000001010111000000100101010101101100001100111001100000000101010000001010111000110000010000000100
00100010100011010011110000101000000000101001010101000100100010000110011000100000000000000011010000010
01000100010100000000100001001001010000110010110101100100011000010110100000000000111110001001110110001
10101000000000000010000110000011111001110001001001110000000100010100011010100001010000101000011000000
10101101000000100101000000000000000101001000000010111001101110010011000101110000000000001011000000100
01111000011110000000001000101001100011110000001000000000010000100010101000001010000110011010100010010
10000110000100000001110000000001001001101100000001011101101010000100011011001000000110100101001000100
10011001000110101010100000000100001000000001000000110100000100000010000000111000000000010100110100001
00100100000001000000111100000100010010000110010100000000010000011000101011101010011000001100110001010
01001000001010000010110100001001000000000100000001100000001110001110100110010000010001001110000000000
00110001110000101010010011010000100101111110000000010000000001010000100000001001000011000000001000000
00010110000000100001001100001001011001100001010000101100011010000001011001000110101000010000001001001
00011011000110010001011001011101010100101111010111001010110001010010100010101111101100110000010100100
00110100001000000010010000110111011110001000110100001010000001010000000100000000010000110110000001011
00000001101001010000010000000011100000011011000000011001100000001011001000001000010001100000011000100
00000000110111000001000101001100000000001000000010000001110010001001100011000110000000100101000010001