96,95
43,22
00100100100000111000000100010110100000010001010011000000000000101001010010000000000000001001000000000
10110000111000000001000000100000010100000100010000110010110111110010100011000001001000010100110001000
11000010000001000001001010100011010011001001100001010000000100000011001100001010001010000000000010011
00000110000100010000001000000101011100000000000000000010010010000001000100100111100000011000011000011
01100100000010101101011010100000001100100100010111000110000000000100001001110111001001111000010001000
00000100001110011100000000010010110110000001001001001011100001011101000000000010001011010010000101101
00000001010000010000100000000001110100001011001010000010000000000000000000000001000010000100111110100
10000101001010000001010000111011000010100011010100100101000100010001111000100000110010000000110001010
10001010110000001001001100010000101000000001110000011000000000000100100110000010001000000101100001110
10000110000110000001000000001001000100010011001000000001100100000000100100001000111000100000000010011
00010000100000100001111000010010010000111000100000100001000000000010000000000011000100000001000101000
00000000101110001011010011100101100001110000000100000001010000010000110100000000100010010001000001100
01000000010111001000000001111000000100100100000100101001000000001011110100000000010001000000001000001
01100000011100101111100010110100001100100000000001000110001110000000000000010010001111010000010010000
00101010000100000000001010010000000100010010010000000000010000000000011100010000000100010010100001000
00100010000001000010000100001000000101001010100110001000000001000000100000000000010001110001110100010
00001000000000000000001000000010110001001100101010010010000111000000000100101001100101100100100100011
00000000000110000010000100100101001001110101110000101000001001000111000101000001000100001101000000000
10100001000000001010010000000001010010000000011010110000000100101001000100101110000010010010001101111
00110100000101001001001001000011100000000111010000010100110001010001001000100000011011000000100100100
10000110000010100000000010100000110000000000000100001010010000000110001000011000010000001110101000000
00111111000100000001011010001000101000010110000010011000000111000011000000001100101100100110010100000
11101100010010100001101000000000010000000000010000100001101101000001110010001100000000011001110010000
10100000111101101001110001001101001100010000101000001000010001000001100100101001001000110000001000000
01000100110000000000100000000000000101001000000011001000000000000101000100110111000101010000100000000
11001111110011110001000001010011000000010010010110100100000100010100001000000000000010000100000110000
00000001000001001010000000000010101000010001000000110001101011010110001000010000001100000100000000000
00110010101100000000010111000110000011010000100000000000100101001000100110000000100101010110001000010
01000000010000001110000100001000000101000000001000000100100000001000001101000000000000010011010010001
10011001100000001001000000000100000000100100010001110101000000001010000010000101000100010000110000000
00000011011100001000101100101000011000000100000000000000001001101000110100000011001010101000000000000
00101000000000000001001111100101111000001000001001010000011001000000010001000000110000000001001000001
10000100100100011100001000001100000011110000010000100101000101000001110010000000010011001000000010100
00000000100000001010101010110011010010000000011111100110001000101101101000000011100010000010010001000
00110100010000100000000000101011000101000010101000010001000000001010110000000111011000100000000011000
10010000100000000000110100100100110000101001000100110010010100100010100000010000011000000010001101010
11011001100001100010001000011010000101000100000010101000101000010000000001011101100000100000100000000
00000001010101010000010001110110011001001010000101001001100001000100000001000100000101000100000000100
00001000101000101100000000110000000011001110000000001110100110110000001010000011010001100101110111100
00100000001111001010000000001010000000011011000100110000010101110100000010010011100110010010000001110
00101001001010110000100000100010011000001001100011011110100100001010011110000001011000010101000100100
10000011010011000000010100011100001010000011111111011000101000100001100000001000000010000001100000010
01100011000111000000000110000000100010000000010011110000011011001000000000110011000100001011010010000
11000101010100000000000000001000000000000110000010000100000101110010100000100010110010111001101001010
00011000001000000000010001000000100000000001000000001000100101000111000110000101000001000010001010000
11100000000001011000000111000110100000101001010000110010001010000100000000000001100010100000000100001
11101010010000000001001100000100000011000010111010011000000111000010010000000101011011011100001100100
01101010000111100110011100001100001000010110001001100000001001101001000000000010010100010000000010000
01000000010100001110000000000010101100100000010000000101010100100010010000000110100100010110110000011
00000011000100010100010000001001010000000100010000100011000000000111011000011010000001100111000010000
01011001000001110000000001000001001101010001011100011011000100010011000010001001001011110000000100000
01010000000000000000000000000001100001000000010000010110001010001000100111010100001001111010011000000
10000000000101010001000001110010010011010010000100000011011100010101011010100001000000110010011111000
00000101010001000000000101010000001010001110000000000000000110010000000111100100000100001000010110101
00010100001001010101101010100000010001010100100010000010001010000000011100100010101100100001000100000
00100000101101000101100000011000000001001000000011100000000010000000000011101001100001101000010110011
00001000000000000010000100000001000100010000000011110000000000010000010101000000001000001000001010011
00000001000000001010111001001110010001111000110110000000101001000011000100000000100100000000000111100
00100000001010001101000000101001001100010000000000010000011101000010101000100111011010001100100011000
01001100001100010101100100000100011000000100001000100000000010001001100000001010000000011100000100101
10000100000000011100100101001000111010000100100011100001001010000001001000000001010100000010000000010
00000000011100000000010010000100011000000111101010000001111101110000000000010000101110000000010100011
10100011010101000100000000100000000000110010000000010000001100000100000100100001100100100000100110011
00001010100000001001001000101010110100011010110010110111000010001100010000100011100001010100000000100
00000000101010000100100111000110100100110110000001010101001000011000100100010110100011000011100000100
10000001100000011001101000001000000000000000000110100000010100010100110000000000000010000010000101100
00000010010000010000000000000010010101000010000001001100000000100100100100000000010010100010110011010
00000010010010000001001110110000000011001000001000110100000001110000000001100001100100011001110011000
00100000000000000100011101001010000100000000110011000100000101101000000100010100000110000101000111101
00010010101000000000000000100100101000100001001001001111100011010110010010000010000110111110000000100
00000110000001000100001100101000000011000000000001110000101001110000001010111011101010110001110000010
10000000000001001000000000001111000101110100100101101000000001100010010110000100001010000010000000000
01101000001110100011010101000000100001000011011000010010101010000000010000000001100010000000010000010
00100010101110101000000100001111000010000100110110001001000000000100110000000001000100001001010111000
01010100000000100000101000010100000011000000000101010000000010110000000110010000010000000010110001100
00000010000010011010010100011000000001000000000001000000001100001101100100000000101101101100000000011
10000000000001011001001011000000000000111000010111000001011000101001000010001001000110001010010100000
01001100011000110100000010001001100000001011000000000011000010000000001000001100001010000000000001010
10000001000010011001000010001100100101011000000000100100001101010000000110010000010000010000010010000
00010000001001111100000110010010001010100100011001000000000010000101001100000001000100100100100111010
00111000000010000010100001010100101101001000010100000001110111110000001001000001001000001110000000000
00101000010000000011100001100110011100000011110000100010001000100000001001010000000000000010001001011
00000000100010000001010001100010101001011001001110000000110110010110100000000000011110010110000010000
01000100000100001100000110000000001010000101110001000001100100001000001110000000001001000000000000010
00100100101000010001000010101001000000010101000010000001001001100010010001000010001000100000001000000
00000011000100000111101001101011011110010000111001000100100010000000000001000000000000001101001010000
00100000000000110000000000000100000110100101010100000101001100000100000011001101011100100100000010100
01010001000000110001101000100010100101000000001100001100010100010001001010000010010110000100000100111
00001100011000001001100000000001010011000000100101000000000010000001000100100110100000100011000110011
00110001000110000011000100000000010100001100010000000000001000001111010000010110010000011110001011000
10010000100000010011010000000110000100001000100001000000000000000001001100000000001000101010011100000
00000000000100000001001010001001000100011011000110100011101011010000000100110100000010001010001010010
10000010111001011011010010001000000001000000100010000010000100000011001000100011000111001110000101001
01000000000001101100111100011100000000101001100101010000000001000100000001010001001010001000000100000
10101000010101011100101000010010001100110100010100011010100001110100000010101100001000010111000000101
01010001110001001000000000000001011010101001001000100101010000010000000010010000100001100010011001100
00001010101010110000000010011100010011000000000110110000011000111100010100000001101100100101000000100
00100011010000100100000000000010110000000010110001000110001000100100001000110000100100001010100000010
00010000100010001001100000100001000100001011000110000011000000101001000101000000100100000000001011010
11100000101010001000000011100000101000000100000010000101000000001010000000001101010101011100000000000
00110010000100001001000001110000000111100000000110101000110010000001011001010101000100000010010000010