28,82
68,78
10100100111101001000010000110100010000000110001000010010001000000000100000000011010010011000010110000
01010000010110010100000001100100100010100010000001100010010101101010010000101100010000000100000110001
11111010001100001000000000000100001001100100000001001000100100001000100000101001011000001100001100000
00000000100100000001101011010110100010000000000000011000000010011011000110001000111010110000100000111
00100100000010001010010101011000011100100000100000101000001000100100110011101110001001000000001100000
11000000000011000010010010001000001111001010110100000101110000101000000001100001000001110111010000001
01001000101010101000100011000010001011100010000100000000011011101001001000100110111010110001110010010
00110100010000100101100011000000100111100000000000010111010010010110000010000000010000101001001100011
00001100000000011100000101011000000000010111000010000100011010000100000001111100000110010000011001000
01000001001100100000100000010101110000001100001001001110001000001000110001100001011000000110011101110
11100101000001110100100000000011001100110100010110101101000110010010001010110000001000100011010000001
11001010111001010000010000001000010000000000001010001111011000000101010000110010010000100010010011001
10100100000000001000000100101001110000100010000000001100001000001000000000011110000110010100000110111
00011100100000010010010100000000000100011100100100000000011110000000001000000010010010001000000011100
00100010100011000000000000010010000000110100000110000010000000011001011000100101000100101000110101001
00000010010000100100100101000000010001000000100101100001010000001011000110001111101001100011011111000
00101000011000000100000000100010010110001101000001100010000100000010111100001000001110000000000001000
00100101100000101101110000001010000011001101000000110000001000010010000100111010000110010000010000010
00011000100001100100100100000001000100110000011100000010001100010010111000101100010110000000100000000
00011101000000100011100001100110100000001010001010010000001000101000100001000001110000000010100000011
10100000000000101010100000011001000100000100000001000000000010000010100010000010000001100000100101001
00000110000000000000000111000001000110001010100011000000111101000100000100111000010101011001000000001
00001010000100010000011010100000000000001010011010001000010000110000000000110111000000100010010000110
00100000000000000010000011110101000000100000010000000110101000010000010100100010001001000110001000010
00001011101010100001111010100000000000001000101101000000010000001010001000010000010100100100011110000
10000010001000010010101100000000000001001000010000001000000000010000001100000100001111100000011000101
01100000001011100100011101000100001101100001000000001010000100000000000000101100100010010010000100100
00000101000011110000010010110000000000010000100000101000010001000000100000010010000000011001010110100
00010010000100100011001010011110010110101110010000000000100000001000100001110001000000010010010010010
00000011000000000010101011101000100111000000100000101010000000101000000000000010000010010000001100001
11000000101000000001101000000000000010101000101000000000000001000000000100110000100110010000011010100
10001100000010000000111000010101011001110001100110110001001010100100010010010000010000001000010010100
00011100001000001000000010001000000001010000000000101011101001000001001010000001100000001100000001001
00000000010001010001000100000011000110010100001011001100010000110010110000110010100000010010001100010
00100001001101011001000100010010100000000000100100001000000010001100010110111100011000111001000100000
00000001100000000000010000000000010100100101100100000011000100000010000100111001110000110000100101001
01001010000010110011000000101110000110010100010001100001100010001111000101000010000111001100100101001
10000000100000010000000000000000010000001001100001100100000011000010101000101000100001000100100000101
10100001100000110000100101100100001000000000010010010010010000001000000010110000011000100100001101101
10111000001101011000000001001100000000100010000101101000000101000000010010000000011001111000010001101
10000100100001010001000100011111100100100100101000100100110000000000100101010000000010100000100110100
01100101001010100010100101001000001001010000000100011001100010000110100101011000010001000000100000000
00100110010010100000001001101110000000101001000000010001010010111011010011001100001100010001010010100
00100000010000000010110100011011000010001000011001010110000100000000101110000110000000100010010010111
00000001000010000100000000101110100100110110010111001010100011000000011000000111000001100010001001000
01010100001101010000010010100000011001111001100000000010000001000110001000010001000001011001000010010
00100000011001001000001000000000100001000000010010010010000000010011000110000000000000010100100001011
00101110100011000000100000000000100000000000100101110001000001000010001110000000101000000100000100000
00000000100001010001011000110100000000000100000001100101010001000010010010110000100011000100000001100
01101100000011100010110101000001110010001001000110000000000000000011100000001000000000100011100100000
10110001100011000000000100110000000110000100010000100000010110011101001000000100011000101010100000000
00001000100000011100000000011101001010000010000000010110000001100010100000101010011000000000101000001
00000010100000010000110000001001000000000001000101010011100001110100001111001000010001110000011000000
01000000000000001001101000000010010000100010010000110100010100001110000000000000100001110011000000100
00010100000010000010100110101000000100000000100101101010000100001010000010011011110010000000001010000
10001001000111000000010000000000001000001100100000000011000000000111100111011000000010010001101010101
01110100000101010000010000000100000000000110100000110000011011000101000000100010000100000000101010000
00000111001100000110001001010000011000010010000001001010001010001100000000110000000011000001110000100
00000110000001010001110100000010000000000110000110011101010000001010110001100000000101110101000001100
00101001000110010000101100000000001000000100110001100010100000100001101000000000000010000000000010011
10110000001110010001100000100100010100010100010001000110110000010000001101000000000000000001000110110
01110011001101000000101100011010000110101001110010110000111000010000000001001100001011001000000001010
00100000001000110001000010011000100100010000011010000001110001010000010001100000011001111000010000000
00101000000010000110000000000010000000101011000001011111000000000000000101000000100100000000100100000
00100101000010100001000000000110100000100100110000111111000010011111000000101111001001000110101101000
01010010000000000110000100011000001100000000110010000000000100010000001001110001011000000010000111000
00100011000000011110100010000000100110000111100010111000001001001000000010000000000001001100000000000
00100000000000000000100000110110000010100100100100010010110100100000000000101010000010101000110110000
00010001100000111001100111000100001010100000000010101010000000100100100010100011000000110000100010010
10101011000000011010100011000011001110110001001001000000000000001010010001100111001100000000000010000
00011110010001100011100010000000100000010000000001000101111001000000001001111000100011100100010010000
01000101000000000000000000000000000000010100010001110000001001010000010000110100101000000010000000000
11111010001010000000010100001000000100110000100000000000010001101100100000001001011010010001011111000
01000100010001000101001010110011101001010000000100001000010100000000010001010110010100101000100101000
11100101000001100010000000001010000000101100011001010000010100001001001011011010010011000100101000000
00111100011101001000011100000010100110000000011110100110100100001011000100110101100110100000000000000
10100100110000101000000111011001000110001000000010011000111101000000101010000000000000101010000000000
11000111000100001001010010101010100010001111101010010110000000100011010001000110000001011101000100010
01000001100000001000100000001101100011000101111100000000110001010100000010000010100100000010100110000
00000100010010000100000100000100000000000000010010010110000001000000101110001101001000000000100000010
01011010000000110000011100100011101110011000010100000011000001010001001100000000000100100101110000100
00000111001000101111001000010000010000110100100001000000000001000001101000000110000000001000100000010
00001110000000000010001100000100000000000100010100101000010001000100001100110010000000000000000100100
00000001001000101100100000000110000001100000101010010010000000100011000000000000000010000000000011000
10001000100000110000000001010100000000001010101000001000011001000000100000101101000000010000100101101
10000010100001100001000010100001001000000010000000100000000111000100001011100000010100000010100010001
01101101000000001000010010001010001101001000000100000001001100100111000000100110011000001000010010111
00110000010001000100010011000010101001010010000100101000100100010010110011000001000010111001010010000
00010000001100110101000010000010001000100000000010000110000100100110010111111111000110010000000000001
00101001011011010101001010000000111001000010000100100100111001001100110000010000010000100000000100010
10010000100000000010011010001000000001000000100010100000100000100100010000000000000100100011001101000
00000010111010110011100000011001100000100010010000001001000000010000001010010100001100100000001001110
10100000000100001100000100101100001000000001000000100101001000100010011011110101101010000101000010001
01010000000000000000000000101010100001110001110101100000100000010000000100100010101001010100101000011
11010010011010000000001000101010100010010000010001001001010011111010110000011011000001000100010000000
00001000100111000000100011100000000010000100110001010010000010010000000000010011010111000100001000000
01100100010000100010010000000000000010110010101110001000110100101101010000000001111010100100000000001
01001101010010000000000100101000010100000100001000011110000000101110000000100010000101010011000110110
10000000000110110110001000000110110000100001010101001111000000010001000110011100110000001110100110011
00100010010100110101011010101110100000101010000010101010001000000100000100000110100010110011100000011
00001010000111000000000001000100001000001000101011000010110000000010111101001010010001010100110010100