69,42
57,50
00000101111011100000000010000100001000100000000010001000100000010010001100001101000011000000000001000
11000000001010001011010000010010110111101011100110000010010000000100001010001111110001001100000000110
00100000100100000001101000000101100110000010010000010011000000100000000101001010110001110000001000010
00001100010000011100100100010000000000100100010000000000000000010101010100010000000010010000100000101
10010010010000100111000100110100101000011000110001100100001001110001111011110000001100111011100110000
01000011000101010110100010011100100110001011101111001000000000101000011001111100001101011100000101001
10110000000010101000000001010100000010100010000101100000000000000010001001001000101010100111000100100
10101000010010101010010000000011000100100000010111000100010100100000000000000000110100000011101000000
00000100010100110001000000000110000010011110100000011000000000111010100110000100100000101000001100110
10001001000110000001001000100011010110110100010000000100000100010010000100001111000000000000011000000
01101000000010100001000110111011001010000111010000010011000010000100000110011001001010000010001000111
11001000000000001010101010010011011010011010000000101001100101010001001000000100000110011001111100100
10000110000100010011000100010100000010001001100011110100001000010111001110000011000001000100000010101
00100100000000000000001110000111010000001011010000000010011001101010010110001010000001010110000100010
10011000000010100100000110100011011000100011101101011110100111000010000000100000100011100001001000000
01010100011110010011000000000001111101001000000100000001010100010101010100000001100010010000011001000
11010010000010000110010000100100100000001000100100001000010100100010001110011000001011001000110000100
00010000101010000001101011100010001101111100101000000010010000100001001000000110000001110000100000100
01011010000100010010000000000010000000100010001000011000010110101000000001100000101100001110000001000
00010000001010010100000010010001111011010001001000001101000001110011010000010010001110000011100001100
00011001000100011011001001011000000001001010001010000000101101010011000001000000000000000000100000000
10100000010000111100010000010100100100010010000000000100000000000000001101001000000000000000010000000
10010010101011001000010000000101000001000001001001010010001101000100000000010100111010000101000000000
00000000001100000001010110011010100010011101000000001101011000101000000100110010001000000000000010001
00000100110111000000000000000010010000010000100000000110100000101001000000000101010010001000101000000
10000000001011001000000110110010001101100001010001000100111011100000000001001001100000000010010000110
11110100010000000000000101010000010100010001000000000010000111000111000100000001100011000010011001001
11100000010001010001001000100000101011100001010000010110110100000101000000000100100001001111000001110
00000011010000110010010000010000010100001000000110010010111010000001101000101101010010000100111100010
00010001101001110010000000010000101010000010100000101011000010001010010110000000111001110000010001011
00001000000011110000010000010000111001110000101101001000101000000001100110000000110001000001000001001
00110100011100000011000100010001010100101110100111110010000101010101011010001000001000000001000000100
10110000000100110000000000100000001100101100110000110101010000000001000000100001001001001000100110001
10000000000000100010000000100010000000000001000000000000000100000001000100001001010000000000011000000
01001100010111000001001000100010001000101100001000000000000000000100010000100001010010010000010010000
00000000000110100000011001010000100001100111111001100100011000100001000000110010010000010000000000100
10000100011010010100000000000000010100100011010010001100110011000001110001000010000001011010000100000
10100011000110010100000000001000011010010000000000010111011011000000000011000010010100100010000001001
00000000100001011000001000010010100010000110000000000000000110100011010010110010011001100011000100001
00101010001001000000010000110100001010000100000000100110111000001000000010011000001000011001010000000
10010001101110011111110100011110101101000000010000000110000000000000010100101100100010010101000010000
10000000110000001000001000000111000001001100101000000100000110000010000110000000000110000101010000011
10100000001000000001110101110000110001001000011000000010000001001000011000000010000001100000000110000
00000100010001010010000001110000010110011100010000010000101111001110010001000001001000000011101100100
10110000100000000001110010001000010011011001000101000000010001001000001010001001110001110000001000110
00000101000000101010110110001001011010000100000001110001000010100001001110011011010001011000100101010
01000000000100010001010011000110000110001100010011010010001100010100000100001100000001010110110100000
01000000000001011011010010000100101000100111100010110011000000000001001000100001011000000111001000100
00010011010101000000000010001001010000011100000000010101000010100000100000000100000100000011001000010
10011100000000010001001001000000001001100101011110001011000100110010000010000000000100000101001000001
11110010000000000000001001000000101100000000000101010100001101011111110011000010000000011001000000001
10101011000100100001000010000011010000001011001001101100101000110010000000000000001001000110100001010
00000001001011000110111000000000000000010000001000000000000010110101001111011101101000110010000000101
00110010000000110000101000100000011000000000001110000000000000000000111000000101001000000011001000100
10010111110000101100101000100000110001000001110000100100100000100101000100110110000000010001110000000
00000000110001010000100010110001011110010101110010000000101010000100100000000100110100100001101000000
10101100010001011101000101011110100000000101110000101000001011101101010000001001101011001100001000010
01100100000110001000100000010100011110110000000010001111011011010000111111001111100111001100111011100
00100011000100001001000110010000101000100001100001101110101000000000100000111011000101001001101010100
10101100101010001010100000100001010101110100100000110011000010010001110001100100100111000000010001000
10000000100000100001000010010000000000000000111000000001101011000101000000000001000010010100000001100
01000011011110100000000100110100010100001000101010001000010101001110100100000000110010000000010100011
00010100100100000010101000110000000001000010001010011000000110100010000000110000100000100001101100001
00100000101100000000000010010000100100000001101010000100100000000100010000000100000000000000000011000
00000000101000000011000000000000010001101000001000000100000000100011011010101010000011000001000100000
01010101110001100010010000000100000110000000010000000010111000101000101110011110000011101011100110101
01011001101000000000000000000110110000100000000001000100000110000100000010010000000000110001010010001
00001000101010000001001000000100000000001010000010100100110000011000000000000001000000001010000000010
01100000000110001001000100101000000100110010001001000010000110001000100010001001000000101011000011000
00000010010001010000101000001001000000101000101000000000100111100000110000000000001000011000010011010
11001001101010000100010000101010100001100111001000001011010010000000001000100000000100000000000000110
00000010011100101000000001001001010000100000100001110000100010000001000100100100011000001000010010000
00000001001000011001000001000001000001110000000010000100000100100010100100010000101001001110000000000
00101000101001000111001010000000000011111001100000000101011011110000100010000101111011100000110000000
00100100111011100001010110000000000011100001000000000011001000001010100100010001001100001100000010100
01001010100101010101001000001000001100100000011011101000000000101001100001000001010100001110000101000
00010010001011100011100000111100110100010010000000010100101000000000100010001001010000010000000010000
00000111111000011101100010001110010000100000000000111000000010100101010001000101011000010001010010111
10010001010000010110100001110001110000010010011010010010100000110010100000001001010000001000010000100
00000000110100101000100001110001001110001000010010000001000100001000011000010010000000111001010100001
00001110001010000000001010110001100100101001100000110010100001000010100000000011001000111100010000000
00000000001010110000000010101000010100001000100000010000011100000100000000101100110100011101000100010
00000000000111101010010000000000010111001101001010111111000010001000000000110000000000000001000010001
00011001010110100001100101000010011000000010000010000000101101000001111010110101100000000000101000101
11000100000110001011100110000001010001001000001110100001001100000001001100010101101000000111001000010
00000010000100110100001111000000000001100000000100101010010010001110010010011000000110000111100000001
00000000011100101011010100011110001010101000101000100101001100111010000101010101011010011010101000111
00000000001011101100000000001000001001110010100000011100001010000100010000010000000001001100000010000
01100111010000010100000110000000000001100100111011000100100100100010111101000110000000000001101010000
10000101001000000000000100011001000010110100110100000001010101000000100111000100100101100000000110000
11010000001000000000000000101000000000100100011000000010010110000000000000100000010001001010000001100
00001000001010001010100100010010000000100000011000110000100010110001000010000101101000000100000000110
11011100000011000101010001001000100010101001000010000000100100100101011010000111100100000000000000100
10010000100000010000001101100000000011000000010001001001000110001011000010010011111000000000000000000
01010000000111000011000100000110110000010011000110110010000000000000000000010000111101100011010000000
01000000001010000001010000000100000000100000100001100001000001110010000100101010011000000111101101000
00001000000001100001000000000010000000000100001010001111100010010000100100000000101000011100001101100
00100011001010000100010000000001001010101011001100000000100101100001001001001000110011010000000000010
00111000010000100000100001010011011011000001101010000001000000000000000100001010011100001000000110010
11001110000000101100001011000110001101010000010011000100111010100010000100000010000001100000010010000
00110100001000100000000100000000110010001011101110000110000000000110010000000000001000000000001100100