41,93
10,45
00000001010000110000010100100110000100101000100010001000000011100000000100011000011010100100100001000
11000000101100110000110011100000111010010101001010000100100011000000000100000111000100101001011000001
00000000010101000010011001010011010110100100000100000100000011010011000100001000000010010001000010001
00000000100101000100000010011001000010100000101001110100110111100000111100101000101100001000000000100
10100110010000000101101010110111000110000010010001111011000000111000010011110000101001100101111001111
00100001110101110000000100100000000010100011000001001010010100101000100000010100001100000000001000001
11111001001101000010000000001001000000010000111001010000000010010000100111010100100010100100100001001
01011000001001101100100011000101001010101000100010110100101001110111001101011000001000000000011101000
10001100110100110000000000000000110001101001000010100100000000000010100111100100101101011000000010000
01011100100001110000000010101010010011100101010001100101000000000000001100000110110000000111010100000
01000000100011111000000100111001010010111100001001100001010110000001010000010001011010000100000000110
00001000000101001000100010000011000101100000111100000100110110001001001000011010000000001100100001000
00101011000000010100010100001100000000100000000000010000001000000001111100000000000101101000100000100
01100000110100111011010110000001001011110001000100000100110111010101100100000000111000010100001000000
01011000100101100000010000110111100000100110100000111001000100100000000001100010010000011100010000000
00100110000110011100000001000010000010011110000000000000001101010000101000100000001100010000011100010
00010000111100000100000000011000110010011100100011001010100100000011000000100011010001001001000100101
00011001010100110001111000000000010011000100010110000010000000010010001000100100000111100001000010000
10001001100000000101101000010000000000110011100011001100000000101001001110000010001000000001000100000
10100010111011000000000001010001011000001111101000000001100011010000110000000100100000011100001100000
01000110111100110100010011000001100010000000000000010100010000000000110000001101110100100000000000010
00010111010010011000101000100011100000000110011100000001000010011100101110010000110001001011100001010
00101111000000101010010001101010010010110010010000100110011110001011000101001000000110000111100010101
00111000001010000111010101000000001011000000100010110101000110010101001010000100100000010000000001101
01000100000110100101100110000000100111100000010000110000011011000001110001000100100001101000011010011
00010101000000011001000001011001011001001110011100100000010000010000011000000000001100010000001000001
01010010001000001000110001000010010000101010110101000001110010001001011000001000010001110010001001100
11100000001110100101010010001110001110010000000000001000010000000010010000010001100000111000010001000
00000011000001001100100000000110110100110101010000100001010000001000000000001111100110000000010101000
00100010110010011000000000110100000001000000000000000010000010101000000010010100101001110000111001010
01101111000011000000000001010010000010000000000000000111000000010110110010000000000000000000010100100
00100110001110010101001010010100001001001100000101001010010001101100110001000000011000010101101010100
01010010110000010100001000000111100010000000100110100010000001110010000000110000001010010001100000110
00110111010000100011000000101110000101101000001000000000101000001000001000110100110110101000000100100
01101000000111000000000000000000010100000100011010001000001010010100101010010100100000010010100100010
01010100000100000000000001110110001100011010010001110000001001010001000100011001100010011110000001001
10011000000011100010001001111101100001010000100001101111001001001100100001010001110001010010000001111
01101000010100010000000101000001101010000101010100110000000001100101000000000000100000000000000100100
01000000011000000100000100010010011000001100000100000000000011110000000000100100001000010111101000001
00000001010010010001101001001101001101111101000000000110010001010110000000001000110000101000000000000
00000000000010001001011000000111000010100100111110010001000100000000000000000011000010001100100000100
01010100000000100100000000110100000100010000011100010011100000001101110000000001000000100010000001001
01000100010010000000110000000000000000000100000001001000111001001010110110000010000100100110010000000
00011000000011010100100110000011001000101010001000000000000000010010000001011100000001011111100000011
00000010000101110100110011110100000001100000100001000000100011000001000100000000010000000100000011010
00111011100000010000010000100000000100010010010100000001000010010000110101000000000001010001001000000
11001000001000001000010010001011010100110100000000000000110010100110111000100010000001000100001010001
11000100000001010000110000010000010000000001000000000100000000010000100001001010010001100100000001010
10011000001000001001100000110000000001001001000001100000100000100001001100000111100101000110011000100
00000010101010010001000101000110001000010001010000010110000110100101101100101101000000110000110011010
11100001000110000101001011101100000011010010000100001011100100010000110000001001000101101001000000011
00001000000000101011101010000101100000010000001100101010000001000010000100000011010011010001000100001
11010010000101001011010010101100010101000100001000000100010000000000000001000010000000111100110000100
00011100010010000010000000000000010000010000010000001100000100011000110010011100101000000111110100100
10010011001101000000000100000001000001101000000101000100000010011000000001000001000001110000100011100
01001101001000000000000100101001001111101111100000100000100100000011000101001000100001110100011110111
00000011000101100011101000001110000001000000010100000001000010010100100000000001000000011000111000101
00001001001100000010001101101010000001001100000101110010001111101000111111001010000010010111010001001
00110000010000100001000011000000000010010000000011010000110100100001000110000101000000010000000100000
00000001011110000000000000000000100000000000000000000001011100100000001000100011100011000001000001010
00000001000000100010001010001111001000000101001000011000100110010100100000100110001000000000000000000
00011000010011011101000000100100001000010000110000000000100000101000010000000100111010010001101110000
00000100010010010011110000011001100011001001100100010001000001000001010000100000100100001010110000000
01100111000100000101110010100000010100000110010100100010001000001010001100000000000010001000000000000
10001001101000000001000010000001000011001010100011100000011010000000101000001000000000011000000011000
10101000100101110100000100110000001000100101010011011011000100010000110011001010100001010000100000010
00000100000000000011001010011000000010001100001010000000000100011001100000010001000001001000000100011
10101001001011000001001110010101010100100001001010010010000000001000000000000010100101100100000100000
10001000110001001000010110011101000101100000000001010001000001001010110110010001001001001101001011100
00100000100100001000011000000000000010111110011100000100000011110010000001110000000010010100010101010
01001000100000010000001000000000100000101011111000001000000111001100000000011110010010001000100100110
00000100101111110000100000010111000000111000000110000001010010100001000000111100001000001100011010001
11100000000101100100100101011110001011101000000000011000001010001000101001000000000011001100100001110
00000000000001010001100000000001001011000000111000000111010100000101000000010100000101000011100000110
01100000000001100001000001000110001000110000100100001100100111100000010010000011100011010011010000010
00000000100000010000000001000100010000010100010000010010001001000001010110101111101000000011001100000
00000000000000001101000010000101010000111000001011000101010101100011001010000010000011101000000000001
00010101100100100001000001000000000001000010010001010000010000011001110001000010001000010000100000001
00011001010000000000000100001011000010000000010110010001110100110000000000000000100000000110010010000
01010000001000000011011110000100001100000000111100000000100011000110001010010000000000000000100000011
00000100010101011011000001000001001000101000000011111101100100000001001011000001001000000000010000000
01011000000010000010010000010001000001101000000001000000101100011001000000011010001010000000000001110
00000000111000110000000111100110011000110110000001100011000001010101000110100001010111010000111000011
11000100010000000000010000000000000000000110101100001111100001100000000000010101000000011001010110100
10000001000100011000010111000110000100000000010110010000010010000011011101000100010000001100010100000
00010010000011100000000101100110010100100010000001111000010000101010000000000101001001000100000010110
00000000010000100101000010000100011010000101101100001110100000101001000100000001000001000101010010100
00011000000000110001000111110000010001000000100000100001001010101100010001000000010110011100000100001
00010110101011101101011100000001000011110100000000001100000100000001000001011100001001101100000000011
10010100100100000100010101100100100000101000110000010100010000101000000110000100101011000011010000010
00000011011000001001010000001001001100000100110001011011000000000001000111010000001000000000100010110
01100000100000001001000000100000100001100101000001001000110010000010000110010111010001000000010000010
00000000000000000000000010010000000110101000010101001001101000001111100000010001100000000001111000001
00000100001001000011010001100100010110000101000001000100000010011000000101000001000100000101101010110
00000010010000100000010111100001000000100000011100001000001000010000011011000101100100000100100100001
00100010101100101101000001001000100010000001000111011100011001000010001001000011100100000000010010010
00000000011000000110000000010100010000010100001000001100000100100010000110010001101001010000011010110
00010110011011000001001000010000100100010000000010100000000100001001000010000000110000000110100000001
00000000010000000100010101000111100011110010000010001001010001000001001010001000000100000100100011001
00000000000001000001011001110000100001001000010001000001001000110001000100100111111010100011001001000
10000000101000010101110000000110000000001100110000100001010100010000000001000000001010100001001010011