65,75
75,36
00101011000000010001000000000010000010000111000000010000100011000000000110001111000000001110100010110
00010000000101011010000111100000001010000000000001101001100000100110100000000010010010100000100001111
01101010010100010000000001000010000000001000000100010101100101010011010001100001001010001010110000000
10101001000010000000001010011000000010000100100000101000000000011100000011100000001000000000001001100
01100111111001000101110100100100000010110010000111010100010110000010000010010101001001000100000010000
00000010111000001010111000011000100000000111000001011110100010100010000101000000100111100110000100001
10000000010001000000000011000110000001010011000000000101000010001001011110100001000010011011000011101
00000000110000000100000000101110000111000000000110100001011000110001110110010010000000000001000000001
00001100000100110000000111000010110110000000000010001011001010010000010000100101101010010000000000000
10000010011110010001010001011011101001000000000101110010010011100111000011000100001010001010011000000
10010001101101000110111011000110011000001001000011000001101101011001001110101000000000000100000101001
00000000010100001010010100101010001100100000001100100000100000000000001100000100000000001000011101000
00100000000110000100100000001100001000110010000010001101001011001001010001000110000010000000111000000
10001100000000000010001100001001000001010101010101111000001000001000000100000001101010101010000100010
01110000000100010001010000101010000000101000001000001000001010100100010011000100000000100000100010110
01001100000000001110001010010010000000000000000000010001000000000001000111010000001000001110011100110
00111111000000001000010101100000101001111000000101001010011000001001000001100010010000001100010000000
10100011100100000001010000000001010010100001000010000001000001110101110010010100000000010000110101000
00001100001001000100001011011010001000110110000010000001110100010100010000010001001111000010010110101
00000110110011000010001010000010000001001000000000010000001000100010001000000000101001010100001110100
11100011011011001010010001011000011001111111101001011010101000100000000101100001010100100100010100001
10001000000001100100010000010001110101001101000010110000101000001011100001000100001001010101010100010
01000010100001010000000001100011000100001000001100101001010010101001000001001001100010100000001110100
11000100101000100001000100101000000010010101000010010000001010100010001001000000011010011110111001100
00100001101000001000000010011100100000100110001010000011101000100001000010000010110100001000000110000
01000001101000010010000100110000000000000100100001000100000011100100110100000010011100100000000010100
10000101001000000100000001001100010010101001000101000000000101001000101001000100100001110110011111000
00101011000000010001100101000000000001000000111100010101001000000000100000000101010000001001000000110
00000001000100101000010001000100000000010111000000001000000110010010100010101010101011110010000000101
00000110000011000000000110101100000000110000001100000000001000000000000001010010111011000000100110000
00010000000110000100010000001100000110000100001001101101101000101000000010000100101000000001000111010
01000100100100100000001010000001001100010000100010001000000011011000000010100100010101101001100010010
10001110001000010000001000011001000000100001001000010000001010001110001001010100100000011011010010101
00100101000001011010010000000000111110000000000010100001100100100001000110000010000011001101000001011
00100100010000001010101000000000000001000000100001101000111010100010000001000010000001000000000100110
01011011010110000101000000010000101010000111011000000100110000100001000011100000001000110011010000101
00101110001000010001000000001001010100101000100001000011001011000000100000000000101011110001010001000
00101100000001001010000011010010000011000000111010100100000000011100000000000001001100001000011000100
11110010010000101010100000000011101100100100101001000000100100010001011010000110000000000000010011000
01100000001001001000001101000100000000011000011101000111001110001000100011000000001000001000000000000
00100100000001000100100100110001000000001101000000001100000010000010000111000100110000011101000001000
01000110011011000001000000101000100100010010000011100100000000010001110000000000000000010001101000100
00001011000010000111010000100011000010111001001001110000100000100000000000000001010010000001000010001
00110100001111000101000100001000010000100111010100110010111000011001000000001100100000111000001100110
00010000001100110010010100010100000100101000001101010100110010110001001100010000001001010001110000010
10101001001000000010101000010010000110000010011100101010100101001000100000001000011000000001000001001
01000000000001000011011011100110111001000001000010000100100011101000000000010000101100100011000100001
10010000110001000000000001000101000001011000010000001110001100001000010000000001110000000001011111000
01011100101101000001110000111100100000000001001001100110100001000001001001000101000001000100101101001
01010001010100100010010001010100011111110000110001000101011101000010000111000000100111100001100010001
11010101010011100001100010010110000001000011000000000000110000100011001000010000010010001000100101101
00101010000010000100000000101110001010110011001011000001101000001110100110110001100101001000001101101
11010000101001110011010001000000100001101001011010100010001101111000010010101010000001101001000011111
00000000100100100000010101101100000001011000010011001010000000100010000000100001010001000000000101000
01100011000000000100100100100110100110000000000111110000001010000011000100110000000000111010100000010
00100011011100000000010000100001000110000000010110011000010000000001100010010010101100011000000010000
00001100011110010010000000111010000000100100100001100001010101101000001001000000001100000101100001010
10000000100010100011001101010110001010010000100101010001000000001010000010011001000110000110000101101
10110001100010011000110001010000100000000000010101000101000000000100000000100000000110110101000000001
00100001001100100000000000010000011110000010010101000000010000100000000100001011001001000000010110000
01000000010100110000001000000010000001000000000000000000001010110011101100000010001000100100010010100
00100000001110000000010000000001001001100001000000101100000000010010110111100101001101001010110011001
00110000100000000000011101001100100010000010100000010001010000000010100010010000110000010001100011100
00001000000100100001000001101001001000100001000000000111001010000100100010001010111001100001001001100
00000000000000001001001100101000001001000010100100001000000110000100011000001000000010000000000100000
00101000100001000001000100001011001000000110101010111000000001100100000000000001001001111100010100010
10100010000000000010000000000001010010110000000000000000100100000001001000100010001100001000010001000
10001000010110100110010001000000110000000100100001000110010001000101001100000000000001100001011110100
10000000100000000101000000010110110000110001011000000000011000011100000101001111010100010000001000001
01000001000000001000001010110001100000111010110101000001100001011010110000100000001100001000101001000
00000111100011011101100011110000000011100010010010001100001010000000001110110000100000000000000101010
00010010000000000010100000001000010011010000110100011101000000001000000001111000011010100000000010001
10111000100100000001001001010100100010000001010010000001001100110010000000000001011100110110100000101
00101100100011100000000100010011100100001001010101000000100001010010000000101000001000001101000001101
00000000111101001000010110110011110000000000001000000000000000011010111000000000001000010001110000000
00101000000000011100001001000000000010000011100001000010100001010010000010000000001001000001001000000
11100110011001100001000010001010000000100101001110110111010010001000000000110010000001011001000000000
00000000100000100001000000011011001000100010001000110001000100110000011010001010010001001000010001001
00000000001000000000010000001001100010000100100010010110010000001000010111000001010011010000001001000
11001011001001000100000001000000010001101010000100000000000100101100001100000000101100011010000001110
00000101010000000101000100010100010000010010000000111000000000010000001010011001110000011010010011110
11100000000111000000000010000010000100000000001000011000110010010000101110001101110001011100001000101
00000001000000001010010101000010100101000001100110100000110101001010100010000011000000001101110001000
00001000001001000100100000000000001001011001011000000000001010000001000000000100111110000100000100001
00000101010011000000110101000001001110110100001000111100110000111101101101101000101000011011110000000
00011010000100010000001100100000000000100001011111101010000001000000010011000100000000110000100000101
10010000001010001011001010001010000010100001100000000001000011100100010100000010100001000010001000000
10101000110010000100100000000001010000010110011100000100100110100000001100000100000101000001000100010
01111110100000001011000111001111011100010110001001101010000000011110000000000001100000000001100000000
00100100000000000000000000100010111100011101110100000000000000010000100010000001001000100100100000001
00000000001100000000100010100110000101101000100100011000010001011001010000000001000110000010011000001
01010000100010100000001110011010000000000001101100000010000100100000000000010011011001010101011001001
00000010010110100010000000000001100100001010110000000010011010000000000111000010010100001101011100110
10100001100000011001101011000111010011000000000100010010100011111000100010110000010000000001000000100
11010010010001100100000000001100000011101010001011000001100101000000110010000001000000100101001110000
10000101100011010100001000000000000010000001110000000000100000010001011001010000000010100000001011000
00010101110000000110000011000110001011010011011100000000000010001011100001010011100100111000100000000
00001000110111001000000000000010000000000000110000001000000101000001000010000000001010001010100001010
01100011100110100000001001001000010100010001000000010000110011001011010000100100001000100100000001010
00100111000100110000100000101000000000010001100001000000111000000000101101000100110100000001001101000
00010010100011010110000000100010000110001010000000000010100010010000101011001010101000010001100010000