22,92
49,42
00100100000001101010001101011001001000000001100001110000010000001100101001000011001001001100001010110
10010100001000100111011010010000001100010001001111100000010001000100110010000000000000010000000100001
01010000000101010101010000000001111111110011011011010010010111000001000000101100000000100100110011000
00010111010101100101000010000010000001010100101000001000001001101000011010101000000001010010001000011
11001000010000001010001000110001110101100011100001000000010001000010000101000101100000011000100000011
00110000100000000000101100000010000001100000000000000001000010110000101000010000101000010111001101010
00100100001100001010000110111010100101000001000000001100100010100100110011000000010101100100100000000
00000000010001000001100000000000000011101101000000001000100000001000001100000100111000101000010000001
10000100100111000010010011000110101011001000100101000000000000011010011100001101111010000100100110000
00000000001100001110000010000000011000010101100100010000110000000000101110000000010000010000100110011
00100011100100100010110111010000010101000000100001000011000110000001000011100101000010011010101101011
11001110011000010010000000101100100001010001000010000010000010000100000001110100101000010000000100010
10010100111101000000000100000010000110010111000100101010000000001010000101000100000011000110000010010
01010010001100000000001000010011000110000010010101010000000110000011001100001100000001000000011001000
00000000101010101111101000000010100000000000011101000000010010110101001100001010000000000001110110000
00001110001001100011000101010010000000101000000001100001101001000111001110000000000001100001001111100
00001100010000000001000010110101011101000111000001100001001001010000000100010000010010110000000000001
11000010001000001010011110110001101011100010000110100110010110001100000000110001000010000001100100000
01000100000001000010011011100010010000011000001000000110101000000001100100010000100101000010111011000
10000000001001000110001001100000100000000010001010000000000100101001001000000001001101111000100000000
01010111100000000000100101100000100100101100000010000000000000000101000010100001010100100001011110011
01011001100000010000010000001100010000100000001010000011101010100000000000100000001100000100000000000
10010010100000010000010001011000000011110000000000010100010011101100000000010101001101110100000011111
00001001010000011000011001000110010100000000000001100000100001001001011101000000011100001010110111101
01010000101011100000010000000000000010000001110100001101010011000100011000000000000001110001000011000
00110011000100001101000001100000100000010000000000110100000000100000011000100000000011100000100001100
11101110010000110001000000101100010000110001110110101100000100010001010110000100000001000010000000000
00000100011000001000001100001011010000011100010101000110001011000001010101101000000010000010000001000
01100010100010000110010000001101011011001101000000000000000000110110000011010000110100100110011010010
11000110000100100001001100001101100001110010100100000010000010100010000000001000010001000100001000000
00010000000100110100000100010000111000110110000010010000011101000000000101010000000101001000010000011
00111100011011101011100000000100110000000000111000100001010110000110010000000010010101000100100100110
01000010010100011100100001000000000101000010100101010101001001001001000001010000001010001000100110100
00011000110101010000000000110010001100000000000000000001110000110100100110101000000001001000010100010
10101000001000100000010101000001000110000110000000000010001011010001010000000000100100010100000001000
10000001100111100101011000100110001000000100000000010111110001011110010000100101010011010010000000101
01011000011010100000101101100100011000010100000010001000000001010000111111010001100101000010000000100
01000110000010010001111110011001110000100100010010000001000000100010000100010000001000110010000000110
11000000100001000011000100100001001000000000001011100110000000000010100100000010000000001100010010000
10001011000001000010000100000000000000000000000000010001100000011000001111000100001000100000110100000
00011001001100100001010000000001100100000001000000000001000010010011010001100010101000010001000011100
00000100100001000010100000000000000011001000000001100100001001010100001000000011000000010101010010101
00000000000010010100010010000000110011011110010000010001011001000010100001000011010010000100011000000
00100100100101000001000010111000100100011000101100000000001101100110000101000000000000000000110001010
11001001001000001000111000000001100101000110000110011010100000000111111000001001111001100111010100000
01001110100110000101100000101100100000111000000111011111000010100000100110100011100110100001000000000
00000011000000000001000100010001100000000100001000100000000000100000110000000000110000010011010110000
00000010100000000001110011010100000111100000000100010000010010000010011000110000111010010000101010001
01010000100100110000000000110000000000101010000110000100000000000100001100001011110011001010000110011
00000001000000010000111001001000000000110000000110111000001100000000000100110000000000000110011100010
01000000110001000001101000000010000000110000000100001001000000000000100000000000000000011000010010000
11001111001001000000000010100000010000000100001000001001110000001000000000000011100000000001000010110
01000001111000001100010000001000100001010011100000110111010001000100100010010000100000110010010100010
10000100000001000010000000000010000010111100110100000000011000101011000100010010000100101001000011001
10010100100011001101000000111100110000111111000001100000000000000111000000100000000000100001000000000
00110010100001010001100100000100011100000000100110010000000110000000110010000010101000010000001011100
10101010000110000010000001010110101000011000000010101001001010011100100000000001011101000101100000011
11100000001000000101111111001100100000101010100000001010000100000000001001000011010010111000100110000
01010001110000000011001110000000000100100101000000000001011110110001000000110010100010100001001110001
01000000110100000100001110000000000001000001000101000000000101100011010010000000000000110100000011100
00000001000110110001000010001100010101100100101000010110000101011001000011100100000000010000100100100
00111100011010000000000100000000001101101000100001100100000100000110011100000100100001101000000100010
10100000000100001010011010011000000100010000110001000010001011000001001000001001100100100001000110110
00000001100111101000010000011000100000000011000110000010100101000101100000000010000000000110101101000
01010001100010000000000000000000011101100000100100001000000100100110001101010000101001000110110010100
01001010000100000001001000001000000001100010010111100000001100010100010001000011000001100111011011101
01100000001100001100000000001100000000001000000001000001100010100000110111000001010001000000010001010
00010000000100000001000000000001000001100100001001001100010100100000000000000011000100000001100000011
10000111000011001100010010000010011110101000010000100110101000100000100110000101000100000001101001010
00001110111010100000001110110010001000010001000000001000000110000110010101010010000001100001100001000
10000001000100000000000000001000000101001000001000001001100110000100000001100110010000010001000110110
11101010101000001011011001000011001010110110101111000000100100000001001101000101000001100100000000010
00000010100101001101000000001010110101000000000101110001010011101010010000000000000000001100001111000
10011100001100001110100000110111001111000101100001111011100010010000001000010010100010001100010100100
00000011000111000100000100001001100111000000001001000000010111000001111000100100110101000101000001001
10000100000110000001100101000000111000000000000000000101100000101010011011001010100000000001011000001
10001100010010111100010100100001000000001011000000011101000000000111001001000011001011000000000000001
10001000000011001000001010000011000000010000001010000001000110011000010001100000001011110100101011101
01000100011001001110101010000010000101010001000100010011000001000000000000010100000001001011001000010
10101110000000111000001101100011110001001111010000100100100011000101110111010100010000100011000000111
01100000110000000000011000011000100100000000010100000100001101001000111010000010000100101000010100100
00110000000111000000000000010000100100100000001000100000000110010000000000011000010001101000001100111
00011110001101111101011100110000001010100000010010101000001000010001000101000000100000100001000100001
01111001000100000000100011001111011101010010000000100000001100011001001100101010010010000100010100001
01000000010001000000101000000001101000000010000000101001100110100100010000100000011001000010011110000
00000000100000001010010000000000010000000010010000000100110110000010010110000000000001001101010000010
01000010000000010010000001100111001000000100000000110000001010001011100101111000000001100010100110010
10010010000001000010000000011010000001000001001010000000010100100000010000000001011000000100100010000
00010001010011000110100100000000010001010001110101001100000000111000000001000000111001100001001010000
01100000000000000000000010000000110000111001000000100010000010111001000000101001000001000011000000111
10010111000100010100110000010011101011000101001010000100001010101001010000000011011000000010010011100
00100010011100100010000000101010001110011100000110111000110100001010110001100000001001001100000100000
00001000100100000000011000110100000001000000000101100000101110110011000001001001111001100000110000010
00000100001011100000101001001000101010101100011000000000100111000000001000001001101110000000010010000
00001110100000001000000000000000001000101010101100010000001000001000000110010000100100101110000011001
11000000000010100000110010110100010010111001010101110010100000011000010000000101000101000100100000111
10011000111001010000001011000111000010000110100011101100000000110000010100101000100001001000101010000
00111000001011101011000010010100000110000011011001110110100011000000000000101000000101000000010001101
10001000000000010100000100100010000001010110010000000100010001101100001010000101110001011001000000010
00100000111100000110101000110011000000010011000100010100000000000001100001001100001000011011001001001
00000111001100101000010000010000000101101001100000010111010011110000111000100010101011101000001001000