23,37
1,67
01010010100000100000100010000000011001100001111010100001010010100000111000100010001010000000000010000
00100000001011010001001010010110111100001010000000101100000010000011011010010101000101100010000110000
00001001100000001110000010000110101101000011110000100000010010000011100001110100010011111010011000000
01011000001001010110010000000000001001001101010001010001000100011110001110100100010100011010010110001
00001011000001000010011100101001000000000000111000000010001101111101000001010000110000001001000111000
01101000101000000010010010100000010110011000011100000101101010000001010000000000001010100000100000010
01101000100011000101000000010100110001011010010001001100000000011000010000010100001110000000011011000
00000001100010000000011000000000000000110111000100110010011000100011000100111000001110110100000101000
00100010001000001001000100110000010001000000000000000001000010100001011000011010100000100000000111001
00000000000110001000010000110001110100000011000000000000011100000001100000111000000000000000110100000
00000000000100001001001100001000001000100000000000010000111000110010100000101000100010101000000100011
00001000010110110000100010001100000010011110011001010000010100010000000001011010001010001010100010001
01000010000100000000100100010100000110000000100111100101001011001010100010001101100000100000110000100
00101011000110001111000000001101001100100000100000110001000001111000100001010000000101000100010000100
01111010000010100000010110011100000100000111001100010100100110000000001001101000000000010000000100011
00100000010001011100011100011100010000001001101000000010100000000000001001000011001110011001000001010
01100010000110001001000000011100100000100100000011010000000011011000000110100100000100100000101010000
11010000010101001001000001000100110100010000111000000001001001100110010001100001100100100001100000010
01001010001110000100000100100110000001010000100000001111000000100001010101100000000011110010000000000
10101001000111000001010000011101100011000000100000000100010111100000100000000000010001000000010101001
11001000000100100001000000111000000001000010000000100101001000010000011010100011000001011000101001000
00010000100000000000101101000100100011010101100000000100110001110100000111000010010100010010010000010
10100110000010010100001000111000000100000001000000100000100100100000001010011010001100000000010100100
11110100010111000000000010100100000010100100000000000001000001100000000000000101010000011111001000000
00001100100000000000100000000000001101010111010000000001010100000000010001000011000110010000000000100
11100010010100000000010000110011000010011000100010100000000001001001001000000000000100000000010001100
10011100011000100000100010100001011000100101101000000110000001000100001010100110100000110000000010000
00001000101000101010101000000000010100011000010010010100111011000000001010000100000000101100001100110
10010100000010001101001110011010100000111000001001010010100000010011101001000100011000011000000000001
00010001011000101000011000010000100000101101000000010010000001010011011001110000000101110100011001011
10000100000000010100010000001000100000100010000100000000000100001110110011100101100011010000000011011
10100111011110000100001101100100111100010110010000011010010100000100000011100000000001010000110001000
00001101110010011010100001000000000000010000001000000100100110010111010010100010000000010010100010001
00000001011000001001001000000000100011110000011110100100110011000000010000010000101010111100000011010
00100011100010101010010110001010001000001011100100011100010000100110010000000000100100001101000100000
11000101111011010011011100011000001000100101000000010000001001111101001111011100101000101000000100000
00001001101010000000001001011000000010010100000000000000001000010101000001100101100000000001000001000
10000000000100000000001011011001000010000100010000000000000000001110000000000101000000000100110110110
00110000001110101000010100000000110000100000000110001011000000011100011000000100000100001011011110100
00111000100110000100010001010010100111101010001001110001100001001000010001000000110000100100100110010
00000000010000000000000000000000010000100000001100000111000000010001000101001010101010000011100100001
00001101010100000101001001100000110010000100000111000101100010001000100000000100000010000100000111001
00100011001000101000111100001010001001000001001000110001000100000110100100000100000111000000110000110
00000000101000110000100000111000000010100000010000100010001010010100011000000110100000011001100000010
00000000000000000111000000000000110011101101000100000010000011000000000000010001001000100001100001000
00000100000011000000100000000010011010100010001011001110110000001001100000110001000000110001001010000
01100000001100000010010110000101110001011010000000010000101110011001010000000011010111010000001100100
00110000100000010111101101011010110100001000010100010000001000011100010011000011010010000101100100010
00001010000100010001011100100010011001000000100101001011100000111100100010010001110001000100000000000
00110000000000011010001000000011000000101100000100000001000000010010000000110000100011010000000000010
01000001000001000001001010010001001000000000100001101011111010010100100000110001100001110001010100101
00000010001000000100000111001010000000000010000001100000000110110000000010000100101000110100000000011
01110000000000010010100001000101011100000000010101001000110011111001010100001000111000000000101100100
01001110100010001000000110010001000000000000000000100000110010010110010010101100011110100101000000000
10000000011000001000001101010000110100001100001010001010000001011010001100000000010000000000100100100
00001010010101010100010100000010011010000001100010100000000001110000000100100101100001000100010100000
00010000000100010001000000000000101110100100001110010010000000000011010010000100001100100000011010110
01000110010001000111000010001010010000010001100000001000000100001101010000000000000010000111110100010
01010000000111000010000010000001100001100000000100000011000000000000000001101110001010110100100000100
10000000000100000000000100101100011101110000000010000111101000001110101010100110010010100011111000000
00000000110100111000000010000001000000001000000100111000001100010001000000110000011011001110110000001
00000101001101100100101000100100110000001000010001100100001001000111111000000010000000010001000100101
01000100010000111000110000001000001001001000000000000010000000000100000001000000000100100001110000010
01100000001000000001110000110001000000001001000111110110110000010110000101110001000000001000000011011
01100001000011001110001000010000000001000000000101000000010000000100101101000010000001010001010010010
00111001000000000000001100111110000000100000101001001101000001111011000000000000001001001001000000010
01000100001000111010000101001010000110000001100100101001000011010110111111100010011000000001000011100
01000000001000100101110000000000001001000101000101110000000000000100000011010000000000100000110101101
00001010100001011000100000100100001011010100000000000000000001110000000010000010010100000010100000000
10001000100100101101101000000000010101000000010000000000111111000011010000100100000001101010001100010
01000001000001010001100000001011001000011100000011010000000000000010010001001011100000000101110100000
10101001010100000000001000101100000000000100000011001110010110111000011001011100100010000101000101000
00101001010110000000111010000000000111001100001000010001100001000000000101000001010010000101100101111
01101000010000000000011001001100111101011110010000011000011001011100001000000000110010101100001011000
01001000000001100001111010000001000010010100001100000000010001010000000010000000100000000001000011001
01101001100001000011110000001000000001100000000000111001000001010100000000000111111001011101100100000
10001000100000000011000011001101001100000000010001110000001000011000111100100100100100000010010100101
10101010000001001100010000001011100000010111100010010010100001000000000011100000001001011011000100001
11100001011000000110010010000000100000001000101101000110000100000000100000001011011100000010000000000
10100000101001010001010100000010110010000001011011010000100001010000101000110001000010000010100000001
00101000001000000001000101110000010000000010000010001000100000010000011100000010010001010010000100001
00100101100000101000000100000100010010010000001000000000000001001001010011100001111000011010010000011
00010100000001001000010000001011000010011000000001101000010100011111101000101000110000000000001111000
00000000000000000111101000010001100001000000101100110001000000000110000000100100000000100100111000011
00100111110010001110010010110010001110001001101000001000100001000000000010001010000000011110001110100
00111000100000001011000111110110100001100111101001001000010000010001010010011000100110001011001000000
00000111000001000000001001000000000000110010101010001000100011010010001000010100001011001000111001001
10100101010000100110000000001001010100000000100001000000100100100101000000001110001001001000000000010
11011100101000000100001000000011000000000000011101000000000001000000000010000100110001000101000111010
10100000001001000001100000000000100011000000100011000001010101100001100101000001101000000101010000101
00000001100000001000110000100000000001000000101001010001000010011100000100101010110010010001010000010
01000011010010100000000100110000110010110001001010110000000001000011101000010100100000001110010000010
10100001011111100000010100000001101000100110110001011111000100010010010000101110000100000101001010111
01100001000110000001001001000000110001001001111011000011011101000001000001000010110100000011110100001
01000100000000100111100110000001110000010100010110001010000000001000101000000000100100000010000111100
00000001100001001100001000100000101100110000010001000010001011000100000000001000110000000001000000010
10110110101001010100000000000000101000010000000010000000011000000000001001101000011000110100101011000
00001000100010000000000001001100100001000100011100100000000000100010000000011000010001000000100100011
11000000000100000000000010010001101000000010011000001000111000111100000100100000000000010011001000010
01100001101101011110100101000001101010110100010001010101001100100101101000101000100000110001011100110
10010100100000100000100101000011000111000110001000000000001000001011000000000001000011100001010100000