81,36
36,5
00100010001010000000000100000001000000000100000001000000000001000000101111100000100000110000001101101
00101001110000001000010100000000010100000011000101100010000100001011001001101000110000010001000110111
11111000000001000000010010000001001000000110001010010010100000111001000000000001100011111111000000000
01010101001100111101001010000110000011011000000100011000001010110100011001000000000000010110000010000
10001000101000000010100110101011001111010010010000100100010001010010110101110010010000111100000100100
01000100001001000010011110001010010100000000001111001000010011000000101000111101000000101100010000000
00010001100011100111000101110010000010100000001000110000111100000000100110011010011001001000001000001
10000000010000110000110100000100010110011000101000000001010000010010000010000000000110001000010100010
00000101000000001100111001010000100000000001010110010001001000110000000100010000000011000100001110000
01100101100000001000100000000100100010001001000001000000000001100010000000011001100000101000000010001
10110000101001111000001000110010000000010010010111001001010000011000011111011000011000100000000100101
00010010000100010110000000110100110000011000000000100011000000001000100110110000100000001000100110000
10110011110011000000101000000110001110001001011110101001001011011100010100100100000100010000001010010
00100010011101000011000001001000011000101100100010000010000100000111100000000100101001010000111100110
01010000101100011000100000000100110100000101100000000010000000010001010100101000101000000000000001000
00010000001011010110000010100000000000011000111001110001000001000001000001101001110000000110100100100
10000001001000001000100001010000001001100100001010100100000010001000000000011001000011101010011001000
11010000000010001000000100000001010001011111000100001100110000001110000000000000100011111100000000100
10010100011100101010010100000110000100101000100011001100001000011001010010100000000000011100000111000
11010111100000010000000000100110011010000000001001000001111000011010000001000011001000000100000001000
11000001001000000000010000000100001101001111000000011010001001000000000101010100010000000001011100001
00000000101110010000101000010000000000101010001100000100101010000110000001000001001110110001000100001
00011001010001100101110001100001101000100101100100101001011110110000010001001101000101101011000010010
10100000100100000110000000101000011001100100000000001001000000010100000000100000010010101100101110010
11000110001001110110000110010000110000100000000000001100100010001001011100000000000110000000000000100
01000010010110100000101110001000110000000100001001001011100111010000000000001110100100010000100001100
00011110100011100100001001100100000000001111110010001100101110010001001000001000000010000100100110100
01000100010101110010110000001010001111000000000000001001010000000110010000001000011000100000000100010
10101000010100010101000001000001000000010100001000000001000111000010100001000010000001000111100001010
00000000101101110111000010001101000000001100000000000001000011001001001010110101001001001100010110000
01010000011101000100001100010010111100101000001111100101100000010010011010010000001100110100010110001
00100010010011001001001101010000000000010000000110001000000101100100100000101100100000000101000000001
00000110101110101001010111010010000000000110010101100000000000011010000000011100000000010110010001011
10010000100000110010001000000110110011100100001000000010010000001000001010000010000000111000100001000
01001000000001000001100010000000101000000111001000001100100110000000000000100000101001011000000010010
00000010110000001010010001000001110110110000111001001010110100100000000000100001000110000000000100010
00011001110000001101001000000011000000010100011001100111100000000100110000000000001011000010100000110
10000000100000111011110010000000110001000100110000000100110110000000000000000000000000010101110000111
10000100100111001100001000100001000000100000011110110001000100000100101000001000011110011110000000000
10100001100100010000100010000000100000000001010010000010010010000011110000010000110101001000000010110
11100001000011100010000010010000000000000000010000001101000100000000000010011010000000110000110100000
00101000000000110011010010000001010110001110000011001101001010010000000000000000010100000000010000000
00101001000001010000000110100000001010001111100000001000100000001111010110000001000101110000000101000
00110000000110000100101001001100100010100011011110001000000000111000000100000111000101000111000010100
00101001100100000100010000000000010110010000001000000110100001101000001000010110000000110000110010010
00100000000000000000001010000010010000000010010010101000010000000001000000011000010000000000100000001
01001100000010000001100001001000110001000001001000110101110010100010000100010000111000000000000100110
11000000000000000000001010010001000100001000001010010000000001010101010110010000000001000100101011011
00110100000000000011111010000000001001000111000111000100000100000110000001001010010000000000100001001
01011010011001000000000000100010001001011000000001001010001000110001100000110001001011111101100001100
10010000000110011010001000100000010100001000000000001000011110000001000100011000000000100000011100011
00110100100011000101101000000100010001000010000000010001010000100000010001010011010101010001000010000
10000000000010001101101100010100000010010101000000010001010100000000000100100000000010100011110010100
10000001100000101000111101010000000000000101000000001100000010100000000000100010100011011001000000011
10011010000000000101101001010100000000000010001000010000010110000010011000100100000001000000000100111
00001100000100000000011101100010011000001001101001001001000000010010010000011010011001000010000011000
10100010000010011000001010001100010011001000000011110001000010000000100000000001000000010110001000000
00001001000100001101010010100010000000101101100110000101101010100111101001100110000000100000000000000
00001011100000110000000000000000100100000101000100001001011000000001000001111000010100011000001101000
01011101110000000100111000000000000000000101010011000000101000111101101000010000000101010001110010001
00000100011010000000100001001100000000000010000001101001000101000100000000010100001000000001010000000
10100001100000001100101000100001000011001001011000110001100000000100001000100101010100100001100111000
00000100100101101000000010001001000000010010001110000000000101000100101011011001000100010000010100010
00000100100000000000001000000000101000001010100010100001010000001100000001000110010010010000000110000
00110000010000110000100000111111000010000001100110001110110011100001100010000000010001000001000000000
00000000011000010000101011001111000000000101001011010000001100010001011100011100010011001111001000010
00111010000000100010101000110000010000100000000001000001000001100000000100000001010001001100010101001
10000010110101000011000001000010000000100000000011000001000001011110000010110111111010000001100000100
00000110000111001000001000110110001000100100011100110110001001010000001100000011001001111110110010010
00000000100000001011011000000000100000101100000001001000100000001101000000001100000001010101000110000
01001010101001100001000101010000000001000001110000001000000010001000010000111011100000000000011000000
10101000001000001010110100100110000000011000111001000100100100001000000010001011101001010010101000100
00000001000000000000010000001000110000000000100000000001000001100101000110000110000010100000001001000
00011000001100100010000000100110000100100010100110010000011000100011000000001001110010100001011000101
00110000001000000000000010100000001000100000100000000000001011101100000101000111000001001001000000110
11100000010000001000000000000110000000010000000011000010110000111100000000110010000011000010001001100
01011000110000000110100001000001000100000101000000000000001000010010100000000100100000011100000110000
00000000100110111001000101010010011100001001110011010000001000000000000000010100001001011010000001000
00110010000011100000111110000000100101000010011100000000110101010010101000110010000001010011100010110
01001101101100000100000000011110110000000100001010000000000001000000100001001100000000000011011001100
01001001100001010100000000100000000010001000100001001000100001010001110100110110010000000000110000101
01100000000110000101000001000000010000000011100011001010011000000100000010101000000100110101010100000
00100000100000000000110110010001100110100000001100011101000000100000101101010011000000100010010011000
10000001000001100101000010010100001100000000000101010000100011001000000011010000110010000011100000001
10001000100001000010100010100010011010000100000000000000000000001011110001000100100001010000000100110
01000111000000011001000001110000000000001000010100101000100001110000000000010010100100000001010000000
00001001000000000110101000110001111010001011110100000000000001110001101000001000011010110000010010011
00010001111010001000010001000001001100011011001010011110000000000101000000010001001001100100100001010
00000011100000000000010000001001000110010100100100000001000100011011000000101010010101011000001110000
10101100000001100010101100000010110111101010000010000000010010011001000000000000001000000000110100000
00000101001001100000001100111101001000101000100000100000011000101000010010000000010011010000000100000
01001000111000100111110100000010101010000100000001001010101110000001100100001001100100000101110000000
00101110101000000100000000000100000100000001000101000000000000000001101001111000110000010000000100101
10001000101000001010000010010011000000001001000100011000000010000001001000000010000011011000010000000
10100010001110000001100110000110011100100010010000000001100000011010000101001000001001111101000001001
00001000000000110000010010010001011111001100010001100000110000111100100100001110000100001000000000100
01000000110000101000000001000000010100000110100000011000100010000000110011101010000000000001000010010
01100000001001111010100000001010000100000001001101100000100100010111000011101000010000000000000100010
10001001111001111000000010000011001111011000110001101000111110100000001101100010100101011000000100111
00000010110110010100000000010000000000001010100000010000010100000001011110111000000100100010010010000
00000000110111000010101100000101100010000001010100001010111000000101011111000010001000000101000010100