23,17
86,26
01101111000100000000000000001010011000001100001000000100000000001001100000001000010000000000000001010
00101000000100000000001100000101000000011100001100000000010000100110000000001001010110110100001000001
00010001000000011110000011001100111011001000010011101000000110100110000111000000000101000011100111101
00101000010001011000000000010000000101000100110110001100001000000101111000000001000010101001001100100
00000000000010010110000010000010100000010000000000011000000000100011000000000100100001001001010101010
10001000000000001001000010000001111010011000000011110000000001000100010100001001000100110100011100000
00000010000011000001100001001000110000111000101011000110010101000100111111100100000000100000000001000
01001101000011110000000100010100100100010001000101000000001100001000000000000000001001101000011000010
00010100001001000100000100001111110000101001000000000010010010000000100000010000000100100100010000100
01010001111000100101000111000010001000010000010000000001100011110100010000000000001000010001000001000
01001101010101100001100100111011101010010000000100110000110001000000101011100000110001000010000010100
10110000000001000000000000000000000000010001001000100000001000010001100010101001000100001001010000100
00100010101000001101010000000111100000101100100001010000000010011000010011000011010001100100000010000
00000100000000001000001000100110110111001010000111000001110001010100011100010000100001000100111100001
00111001000001010011011001001110101000110010010100000001010000000110100001100001100110000001100001010
10011101011001100010000000000001001001000000010000010100001001110000101000100000000000000100101000001
01100000000010000000010110101000100110010000000000000000101100000110100000110110011101010000100011000
10001011101000110000011001010010011001110001101000000101000000001000000010000000100001010000000000000
01010100000100000110001000101000100010000010010000001111001010100000100100000000010001101000010100010
10010010001100000000100010000010100101000010010000001010100010010001000101100000000000000010000001000
00000110010000000010101010000000000110011010000001000100101001000010100000101001100110100000010101100
00000000011000100000100001010100001001011000000111100000110000001000001011000100000010000000000101000
01010100001100001000001101010001110000000000000100100001000010000001000000000001100000100011100001011
00000100000010100000101001000100000000100101110101000010000010000011010001100011000000000110010101000
00101100100000010100000010000010101000001000100010001110010110011000011100001010000010101010001001000
00000000010000100001001000010000000000101000000000000000011000010001001001110000001000001011010100011
00001010000110000010001000010010000110000010001001001000010001101101000100100001000100000011001000100
00110000110010101011110000001001000100110011100000010000110000010101100110001000000000000000000000000
10000100001010010000000001000100001000100100110000000010010111001100000010110100000010110010101000010
10001110111000000100000010101110000001011011000101100011001010101001110000101000010010100010010101001
01000000000000100000000010101111000001000101010001000001000100000010001010000000000010100101000000111
00100001110000100010000000000001100000010011001000000000001101010110111000000100010010110100100000100
01010000000000000110100000001010010101000001000100011010010000010001001010000000000000001100001000100
10000001101110001001101100100000000000100000001100000001000000010100001011111110001100000000000010100
00100001100000100010100001001001000111001000011000000101100010001001000101000000001000000100000001000
00000110000000000000000011010000000010010011001100100001100110010000000000100000110010000000000011000
10010000101000110000000000100001000101100000100001001010000110000101001000010010010000000010110000101
00010110011000000100010011101010010000001101011110000001101011000000100001000100100000000011111001001
00000000111010001010111011110010011100000000110101000010001010001100010110111010010001010000000101000
00010110010000010111010000001010010010010010010001001100000111001000100101000001001000001000100010000
00011000100100100100010000100000010001000000001000000000000000101001100110010000001011000000000100000
11000011110000100100110100000000010001010011001001110001010100010000010000000010000000101001001010100
00001100000000001000011001000010010000101001010000010100100001000010001001101110110100110010110001100
00010000000010000000000110100010000101000000011000000100000001100110000000100000000000010110100111000
00100000010001100100000100100000101000001000000000001100000000110010010001100010000000000010100101001
01101100000100001001000100110000110000011000110111000001000001000001001011100011100000010000000101001
11100000000100100100100100100101101000100100001000000000000000011001000001011000010010000100100100101
00100000010000000000000100001010101100010000100000001000001000011011010000000000000010001000110101010
00000001001000100110100100011000011000000011110011000001010000000100001010000100000000010110010001001
10010000001100001101100010010100000001010001010111100000101000000100100000010100010000000100000100000
10101111000000000001010011011000011000000010001010010100111011101100110000000100010011100000010100110
00000111000101001101000000011000011100000100000000000010000000000000010000000000001000010110001010101
00010000001000001000000101100010010011001000011100100110000000001010001000001000100010000010000000010
00000010100001010100101000011000000000100010100000100011000101000110001000010111010010110100000000000
00001000000001000000000000000001001000010111100000000011100101000000100010011001001000100011010001100
11101000101000000001001010010001110001000000011011011001101010101000000010000000000010011000000001001
00101010101110000000010001010101101100010000000000000011110010010010101110101011000000000000000010100
01010111000010001110010011000110100010000000000001100000100000001000000001100100100010001110011001000
01000000010011010100001100010000111111101010010110000010100010010000000010010001011000000000010011100
01000000000000000000100110110000000010000100001000000001000000000000000000001001001000101001001010000
11000000010110000000000011010001001011001000100001001000000100100000001000000000001001100100000001110
01000001011000000000100001001110110000001011110110000011011001000000010110010110100011100001001110010
01000000011000000001111000001000101000000100000000000100011000010000000000000010001001000100001010000
00100011011001101000101100010001000000010001000100010010000100000000101001111011101100000110000011100
01000100001101000001111010000010010000110001000100010110001000101000100100100010101010000000010000000
01011010110100000010101100001000010100000100100010001000001110000000010101010000111000011011001010110
00100000010000000100000100110110100100011010100001000100000100000000011000001000010000000001100101001
10000000000100010000000011001111000000001011100011100000000111010010000001100101011000000000110000110
00100100101000100000000100000000000101100010110000011000010000000100000000010001010011110100001000100
00010100000000001011101010011100100010000000000001101000100100100011001001100100111101000010000000001
00000000011000101010001000010100100100000100000000100010010011001001101000001001010110000101000010000
00110001000000000000010000000000101000110100000110001101000110010101000111000101011010000100000001101
00010010010000000010001001001001010000110101000000101001101100000010000000000000000011000001001010000
00001001000010010000000100101100000100100000000001000000001000000100000000000111000010000100000111000
00010000100110100000010000100101000110010010000001001001101001010100110000000000000001110000000101000
10010010011010011000000000010010000110100000000000010011000100000100100001100000001001010100000001000
01000011000010010011001010000000010011011011100000000000000010010101001000101001110100010001001100100
00001010100000110010000010101001010000001100000000110000000010001000101100001001100000000110000000010
00110000101001000101101011010101000101010000110000000000000110000101100000000010101010000000010010110
01011000000000000000101100010100100101010000000101100000111100000000111001000000001010000000010110001
00100000011000000100100001101100000011010100000100001100101100000000010000100000001011100000000010000
00010001010011001001010000101001000000001110000100011100000000010001000000101000100000001100000011001
00000000001100011100110000010100000100001010010001110011011011000011100000010001000111000001101010001
00000011001000100110001110100100010101000000000001010100011000010010001000000011000001100000001100000
10110000000100110000000011000000000110001100100000001000000100000000001110100000001000101010000011000
01000000000010010001010101000010000101000100010010010010000010001001111001100000000000110100110000001
10011000000000001000000001001111000001011000011000111101100000110100100001000110010111000100000010010
01010100011000100000000000000101110100110101010000110000010100000000000001000010001010000001001110000
00100001011000001010001001000010011100001111101000100010000110001000000001001001100011000110000001001
10000001001000000001011011110110000000000000100000100000000110111000000000000000100000011000011001011
00000110000001001001010000000100001100010010000100000100000010100100001100001100011000000000000000100
00001001000100011110010110001100010000001000010101010000110000010010110010101000001000101010010000000
10001010010000110110110100001010100100000000010001100100000100111001010010001000010001010000001001101
00011000000000110110101000010011001000001010000001001010010010101001001011010000010100000111000010011
00000100100110001000001000001001100010000110001110000001000001010000011001000000000100011001010100010
11011001001010001001001100101010000001001010001000010101100100110000010101100100111000011110000110001
10001111011110000100000101111010111000000000010001100001100000010000001000010010010000010001001000100
10000000000110000000000000100010000100001010000011010101100010100001000110110000001101001001110010110
10001001000010001100000100000010001000000000000000000001011000001000000101001000110001001000001000000
00000001000001100000000000100011100010000001000101000100000000000001001000000010001000000010000001000
00000100101001001011000101100010001000000100100010010000000100000100101101111011011110111000001100010