32,21
100,33
01000100100111000000000000100001000000000100101001100100001100100000000000011001000000000001100100110
10010000100100001001101111001000110000010000001010000010100100000000100101010000010000101010011110100
01000000001100000001110100010001101001010000111001000111111100111000000000000001000011000101000010110
01000010101110111110010010100100110100000000000000000000010000000011001101110001000000010100000000101
10001100000000100110000110111000010011101011001010001001001100010010000000100110000000010010000110011
00101001010110100000010001000010000010010001111000100010000010110001011100011110010100011001000010001
10101010100010001000000010000110100010011001000000100000100001110000000100110001100001010100001000011
00101000010000000100010100010011000010010001100101000001000011000000010100010001001101100000101010110
00100010011001111101001011100000101001100000000000100001000111000000000000001000011111000001000010111
00000100010010010100001000100001000100010000000011000000000000000001000011000001101100000100010001000
00110010000001011000100100101001110001111011000000101000111010101100100000000111110000010011110000010
00010100000111100001000000011110000100010100001100010100001000010010100011101001000000001011000000000
10001010000011000000010111010011011100010000001010000000001101011011100001000010110000001010110011100
00110000000001001000000000100001100101001000001100010000000001000100011000000000100100010000001011001
00000000010001100100011110100010000111100000010010100000001111000000100100110110000111000001001000001
00001000000101000011010101010000001011000000100100000100101000100100101000100000101000000001011111010
11000011000000000000000100001001000001000000000001001010000001001000011000111100000010000001000000010
01000001010100101000010000000010000100001000010000000010000000100110010000010000001000010000001101011
00000000010011000100000000011101100001000000000011000000010010110000000111000100000001010001110000011
10000000101000100001010111000111000001000111010110100000010100100000001000101000000110000001000110101
00100000001001100010000000010100000101000000010000000001100001001100000000101100010010110000001001010
01000000000000001000001000000000111000100000011000001001100010110010100011010000000000001001110000010
01001100010000000101100010000001011011011100101111000001000000010010011000010110011101110000010000100
10011010000000010000100010010000011000010101011100010000000111000100000000000001001000101001110100101
10000011100000001001100010101010100010001111000001100011110011001000001100000000000010000100101001000
11101001011001000111000001010111110100000100101100101101001100010010000100001010001100110001110010010
00101001001010010101010100011010010000001000100001001001100001100010000001010100000000011011010000010
01000000100100100000111001000000110011010001101010100100110000100010101000101000000100010101010000100
01110000000100000101110100000001000100110000010011100001001100011010001000000000000001001000000010111
10100110010010011000110000100001000101100101101010000101000000001000100100000001000100101001010010010
00010110011000000100010000010001101010000100000011100100001100000101000001000110000001100000010000100
10010000011111000000000101000100111011100101110100001001100000010000100000000100100000001001000000100
11000100000100100100000101000101001000011000100000101010000111000010001001000000101001100000011101000
00000011100000101000000100100100000001101000000010100000010001000010011010100011000100101000010110001
00001011000001100010010000011010111000010001011000011011000011110000110000000111000010000110010101000
00010010000000000000001000000000000000100000001000010010000000000000111000110100000111100010000010010
01010000000000000000100000100000101000000110000001010100001010100100000101000010001000011100010000011
00000000000011001011000010010000100011100110111001000000000000000000010000000111011000101000100100100
00000011001010001011001001010001011000001100000001101110011010001001010010001010100000010000000000000
00110100110010100001100110000011000101100110010011010010000111010011100000000010001011000100000010000
01010000100000000010001000000000000001110101000010001000101011110100110000010000100000110001001000000
00010011001010000101100100000110100001011111110011000000011000100000001010010000000000010001100001000
00000010001010000000100000000000110101100000011100000100010000011000000001101011100000001100010000010
11000001000100010001000001011000010010100100000011011101100100101110001001000000100100000110000001101
00000101010000000100100001010000000110000100101010000100101100010001100000100000010101111000000100101
10110001001000100000000010110100101100000001010100100000001001001010000100001110110110000000000010000
01000010100000000010011000010000100010000101100101000100001000011110000000001000000000010000001001000
00001010010000000000100010000010010110000101111011000110010000110001000001001000010001010010101001011
01000000000000000101101001000001010100000000000101000000010000110000000000001001000011001000001100101
00100000010001100000010000000010100000101101100000001001001100111000111100000000000000101100001001000
00000000110001000001010011010101010000010000001110000010110001000000100100011000101110000000100101001
10001101001001000000001001000100000100010101000001010000000001010000001000000100110110010001010001001
00011000000110000001011000000001011010001100011000001010100000000011000000001100000010000010000000001
00001100011110100101000110100101000011000010011000100000100000010111010000000011100100010001010011011
01000101000110001011000110000000101010010011010000100000001010000001101000000101110000010000000111010
01001000001000000000000101011001101010010110010110100001100000010000011000010100011000010000011011001
10110100110100010011010010010100001000001010010000100000100100110110001110111001101110010011100001000
10010000100001110011100010001110011010000110110001001001100111101010010001011000001110000001000010000
00100001010000000111011100101101101001101000010001001101000011101100010001011010100010001001100000010
00101000100001000110001000000000011001011000000010100110010100000110001000000100001001001000001100000
01001000000001000110000010110000001000100000100011010001000000010110110100000000001100101011000010000
01001000000101100000100011000100101100001010110000011010010011100000000110100000001100011100101100000
10001000000010000010011001000000011100110010000110011010000000101000000000001000000000011000010000111
10010100110010111000100000100110100010010001010000101000000100000000000010100011000000000000100010000
11100111100010000100001000000000010001011000001001010000000000010001000101000100101000000000000000100
00100001011000011000111000001010111000111011000101001001000100000101010001000000001101100010000000100
01110001010110110110001101110011000110000110001100110100011010101011100000100010000000010001010001111
10110000000010110010000001101000100010000100010010011001000000000110110010000110000001110110010000100
01010111100110000000100001011110000000101111000000110000000010000010011010001000011000001010100100000
00000001010001000000100110000010100001110101010000001010100010000101000111010100101000100101110000100
01100000010101110001101010010000010000011011100100010000000000100001010000100111010000100111000111000
11010011100000100000110010011011001010000101010000000001100001100010000001100001001100000010000001011
00011000000000000100001000000000001000010000010100011000100100110001000100111010000000000001100100011
01000010001001011000001000110001000100000000110101001100011100000001000010001001101100000110010101000
00001100000000010000000001000000100101000110001001010110110000000001010000010101010000101011010100000
01000011011000000000100011111001001000111000000100111010010101000000100011010110000100001001010100011
00010101000110101000000000000100100100110000010100101100110010000100101000001100011010010000000111010
01000000000010000000100001000001000101010100000110100100000100000100110000001011010001001100001000110
10001000110000000000110001100100001100001011100100000000100100001110000000000010100101100000111010000
10010001101000101010110100110011100100010010000101001011110110000010010010010010000110011100000110010
00000000100000000010010000101001101010000000101101010000011100010000001000000000000000110000001001011
00100100011001111001100000001010001000000111010001010000000000000101010100010101011100100000101001001
11100110000001101000101000010000100000000011101000000110010010010111011100110000100011101000100011000
01000000000000001100010010010100010100010000000011000011000001010000001000000111000001000000110000101
00010000011101000000010000010100100001000011000011111001010000000000000000000001111010110110000000000
00000001101000010100000000001100001001000010100100010000010000010000010011011010000010111001001000110
00010100100011100011001000000000000001000000001010001011000001101001100000010101100010101100100000010
00100001100010110100001000000011101010100001000000000001000111010110000100001001010001011001001110011
10101000100000111100100000001111010100100000000000010001101100101100010000000000010101000000100100100
01010000110010000000001000100101001000111100011101000000000100001010000011001001000110001100010000010
00000101010100011101000010000010000000010001100000110010100100100000000100010000010001000000111000000
11010000100000110010100000000000000001100001010100101000100010000100000010010010000000010101001000101
11000011000001010111010000000010100010001000000101010110001001000000010101110110001110110001110010111
00000010010011100111000110001010010000011000111000000000010010000100010000011101000000001000100100010
00100000000010000010000010101010001000000011011110001001101010001000000101010010100010001010010000100
11000000100011100000000010000110010001100001001000001001100000010000000000101100010010000100100111001
10010010000000001010000011010000000001010110100001001000000101101100000000000100001000010001000000000
01000110101111110100000000000000000101000000100100000011001011010100000001110001010100011001000000001
00001011001000011100000110010001010010000101100000010110100111001000001000010000010000001010110001010
00000110000100000010000100001111111000010101000011010000100011000100000110101010001000101010000000100
00001011000010011010011000000001000000000000001000000011010011000110101001000000101000001000010010101