86,50
57,43
00001010011010010011010101010000011001110110011011110010100100001000101010010010000000010010100001000
10001100110000000000101010100000010000100000000100000001000001011111100010011100010100001000010110001
00100110000010100000010001000100010000010101000000001000001000010010000000001000001000000101000000010
11100000001001010010001001110110000100000000001101100000001010001000011000000001010001000000000010010
01000100110010100110010101001001001011001001000000110001001110000000111010101001011110000010000100011
00010000010000000000010011100100110001010010000000000010000101001100000011010000000100100001000100100
11000000001001010001000000001100000000101010110010000011001010110000100111000001101000100000000110001
00110101010011101010111000011000000000100010000000010100111000110110100001001011000101000100000100001
00001010100100000111000000011001001000010101000000010000000000110100001000101011001000110000001100100
00100000001001001000000100010001000010001000100100011000000000101010110010001000000010010001011010111
00010001100111100001011100110101100000011000001100010010001110010000001000110011010000000000001000001
01000000000010011000000100000000010000000100000010110000010010110000010111000100010100010100010010011
00100100001101011001010000000100000000000101100000010100100100000000000011100010111100001000000000100
10001000000010001010001100101010000001101000101001100100001101100100001110010111010000001000000000001
11000011000000110000010000010000001100100100000010101010100110000000001001100000001000010011000000100
00010100100101000100110110010000001001000010101000100001001000000000000000000100001010000100010011110
00110100000010111001110100000000110111000001101000000010010100000000100001000110110101010000110001011
01100010010000001111010100010101001011000001100101101111101000010110000101000100101000011000100100010
00000001011001110000011010010000100110010110000001001000000011100011010000000110100101000100000001000
10111100001001100010000000001001010101010101000000001000100001101010000010000101010010111011000010100
01001001001010100110111110000001000100011101000000000000101001000000001000011101010010101000000100010
00001100011011100010101010001000000001001000000100000110100010011010100001001000000101010001100000000
00000101001000110011010110000000001011010011011111001011001000000101101001000000000011000100000010010
00100000100010000100001100000001011011111000101101010000110000101100100000110100000001100111010011000
01000000000000001100000000100011010011010101000011101001000000000010100000101110001100011110010110111
00001000001100000010000100000000011110010110010010000001111010000001100000110100100000000001000000000
10010100010000100100000011010110100011000000000000111001010000001010011011100001001001000100000010000
00101101001010101111001100001000011111000011011100101000100001000000100000011101001010100011010101111
10110000000100000001100000100100000110100001001000000000010101110000001010000010100000000110000000001
01000010000100001000100100100101000010000001000000000001110000000000100011010100001011100011100000101
01000110000000010000101001000000000100010100111101001010000001100010011000010000000000010101000010000
10000000000011010010010101100000010101000000100100000001111001101010010010110010000111100011101000010
00010110011100010101010000000010000001110100010000001111000000000111000000101100011101001100000011100
00000010010010001100000100000001100010010001100101000000000100000011011001000100000010100110010000010
11000001001010000000000101000010000011000001000110100101010010100001110110000011000011010100101111000
10110000000001100000010001010110000100011000010010000100010000000111111011001001110000100000010000000
00000001110000001010110000000000000000000010010100000000100000000000000010100000110000000100000010000
11000000000010000011011010010100001100110000000100000010101100000000011011000001010000100100110010001
00001000010011001000100010001100010010000100000100101000011001100110110010111100100000011001010001001
11010000100100110100001000000001001011000010011011100101000000010010010001001001000100100000001100010
00110010001111100110000000000000100101000000100000011000101000001101011010010011010000011011100001011
00001010001000001000000110001001001000110001000000111101010101000001000000101000100001000011010010010
10000010010001000001000000000001110101001000010100010010101001010010000010000100000101001010000000000
01001001000000001010011001000100000000000100100001000000000000000100000000101000000110100000000110100
00111001011000001000001111100100011010100000111001110000000010000010001111010000010000010000001011001
11101000000000001100100010000010100010000100011100101000000011000000011100010011000000000110000001110
10100000100101101000000100001001001100010000000000101000001000001001100100011010001100000000110101101
00000000101001110010010010000000010011000100000101010001100100111000101010100100101010100010010110110
10000010001110001000000000000000011101111000000000000100000001001101011100010010000010010000001000000
00010010001010110010101100001100010100000000010010000000100001001010000111000000010000010000000001011
00001110100000000100100000001000001101001000110000001101000000100000001110010001000000001010000100110
00110010001010001000000110000100000101000001100001000101001100011111001000000101110000100010000001001
00011000001011000010100111010101100010000000000100000100000011101000001100001010011100101000001010000
11000011000000000100011010000000001100100100100011000100000000001001100010110010011001010011000010000
11011101011000100011101000000100001001000001000110100111111100000000011000100011001011001010001000110
10010010000001000011010000000100000000000001010101001000001000000001000001100010100000001000011001001
00000000011100100001000001101010000000110011000000010010000101000000010100111010001101000000101001010
01011000000010100001010010010010000110010001010000001110100100000000010011000011000000100000001010000
00000000011001000101100000010110000000000000001100001101100010001000111010111011010101011000000111100
00001110011000000000100000110100010010000000000000010000010001001000010100110000001010000000000000010
10000010100111000111000100100111010000001010000000000010011000010000000110110011000000100011010101110
00000001001001001110010001000111000001000110110000000010000000000001000000000010001100000100000100111
01001010000000001010001000000001100000011010001000000000101000001101110100110000110001010110000000000
01010000100100000011001110100110011010000000000110001000000000000100100000100000111010100100010110000
01000100000011000100000110110000010001001101101001000010010100111100110000100010011100000001100111001
00010010000001001100000001100000100001000000000100000000000000010101001010011000000100000100000110100
10100100001001100000010001000011000000110010000010110100001001010100000000000100101010111100011101001
10001000110010100101101010101001000000000010000001100010000001000110000100000000000000110001100000000
00010000101100000100101101110000000011111010000000110001000010011011000000000110000001000010010111101
10100010011011011010100000100100011011110000010100011011100000000000100111100000010010100000000010100
00100000110001000000000001001000001001010001011100010000110111000011101010000000010110001100010000000
00100010000000110011001000010001111100011100100110010101000001000101000000011110100000011010010000000
00000000001100001011100000110000101011000110100000100000000001001100010000001010000000010110011111000
00001100000100011001001001100110100000000100010100001000010010110100000100000101000100110111010000010
10100100100010100001011011010010100100000001010000000001010010101011100011000101100000001110001000000
00000110100101001100001000100000000010000000000101000000000110110001000001000000000000000001110100000
00000000011001000000010110010000010100100010100001000001000100010110000100001000010010000010000000001
00011000000001101000001000000000010010000001000000101011011100000000010000000011000000000001100000000
00000000100010100101101010001000000011000000010100000100101000001000000001001010100110000000000000001
01010000110000001101001110000001000010000111000010001100100000001001010000010000110000001000101000100
10100000000000001101101010101100000110001011100000100110010001111010010001001101000000000101010000110
00001110000001001100000101000001101000011010000010100011010000100001001000110100110111110001100010001
00011011100000100001010011001001001110001001000000000000011010000001001000000010000110011111001000010
00001100100001011000000000001110000011000100000100101010000111100001000001111101010000001000000000110
00010010110000111000010000001010000000001001001100000011000000101101010100011010000000010010111001001
01101011000001000001000000001000001100011000010000000110001001001100001000100011001001000100010001000
00000100000000000001010110010001010001100010001000000100001101011100100110000100010000100011001110100
00000010011000000010101111010100001000000000010000001001001010100000000010000010100000001000010100010
00000010000010000010010001100101001000100000000000001000000000110100101110100100000001110100000000010
00011000101000010010100001010000101001000001000000000001001100010011000010010000010001000001010000000
00011000100011000100101101001100010010100010101000000011000001001100110010001010000100000011000000000
10001011001001101001000100000001000000111001001000000000010001001011000101100100000000101110100000001
11001001010010000000001110100100100000101010001000010000000100100100011100010011000010110100111111010
00000110100000000100100100001110011000000001100100000100011011001111010000000001000000101110100000011
00000100001110010101100010000000000001001110101100000000000000011001100010010000000001001000011110010
00001011100001110000100000000001110101011000100000010001011000010110100100110000001001000000001110100
00001001000010000000001000000001000010001100110000000000000010100000101000110100101000000001110011000
00011001011110100110000001011000000000100000001010000100000111000010000001011001010011011000000000011
00001011000010000010010000000000001110001010001010010001010110000000110010000000001101110100100001010
01000000000100000001010100110001000011001011010110000000000100001000101011000000001000001000001000111
00100100000011101000000001001011000110000000010100101110000010100000010000000001100001001000010011000