68,38
56,29
00100000100101100010110001000000100000000100001100001100010101100010000010101000010000011001000000111
00001000000000000001000010000000100000001011011100010100000011000000110000000000001100010000000010011
01001000000010000000001010000010000000100010100101000100000011000100101110000111000001010100000000000
00101001000000000010000010000000000001010010010000011010000000100000100000100000000001000100001000010
10000000010001101001010101100001100110000110110010100010000110000011011001100000100000000001111010010
10001000110110000000000100111000000101000011000100000111000010001011001000000000000010000000001011110
00000011000111000101000000001010001000001010100101001001101010010000001000001001000000001010000110100
00000010000101000000110111001001011001000000101010000011001000000110001110011000100001011100000110000
00100110000001010010010000001100100011000100010011010010000000110110110000011110001110001100010110000
00000000111101001000000011000110101001000000000100010000110010111101010100011001000110000100100010000
01001101111000110011100000100110000000101000001000000000000000001001000001010010001100001000000100001
00000001000000000100000001000000101001001001001000001000000100000000010110110000100010001110000100011
00000001000000111001000100001000000100011110000010101101010001000000001010101000001101000000000100101
00000000000101001000100110010000011001001000001000100001000010100000111100000101001000000010010001000
10000100000000001000010100000100010010000101100000101010110000010000100000101100010001010010000101101
11100000100111001000000001000100101001000011101011111110000111101000100000000000011100000101100011000
00001000000100011011000000010000000000011000000001100000000010000100000000011010001100000000011010000
00001001011000001100100001101000001111000000011111100001000000010000010010110010111010010000100110010
01011000111000101000010010010000010100100000000000000000011001001000111111101010001111001110010000011
11100101100000000000011001010001010001001001000000001010011000010100000100001000000101100001011010100
00001010000000010000010011000100001000111001000000000001110100000111000010000000001000100010010010001
00001000001000100110001010000001010000100001001010110000001010001000000100000000100000011111000011000
10100111110110000101100011000111000000010011110111000000100001000001000100000010110001010000101000000
10000010100000100001110001011000100001101010000001000000000010001100000010000000000000010010100000000
00011101000010000111000010101000000000010010010100010000100001001000000011010000010000010001101001000
00101000010010100000100001010000000010010100111010010000011010000000010000010001000010100101010010010
10000100100101110000110000110000001011010010000000001000100000010000100010000011101000000001000100001
10100001110000100001000000010100000101010000010100100000000010001110001001000100101001011001000000000
00100010000111110010111010000001001110000011001001100000011100100010100000111100010000111001001011100
01110000001100000001100001010000000000011000000000000101111011000000000010011001000011011000010000001
00001010000100001001100000001010001000100110010000100110000010000000011000000000010000011101100001000
00000001101100100101000000011001000100000000001100100110010000000000000001000010010111000001100000100
00001001100101110000111001110000000010001000010000000010001000000010000001010000011100010000000100011
00100001010000100101011110110010011000000010000000011000101101100111101000010000010100100010000100110
00010001110000011001100000101001110000010000100100100001011100000101000100101001111000010000101010000
00110100001000101010000001000000110000100000000100000000110111001000000010000101010010000001001010100
11110010011001011010000010001100100110100100100111001010001101000111110111001000000101000001110001000
11000000000010101010000010000000010000010010001010000001010000110101000010000010111011010011010100010
00010001000010000001100110001000110000101000100000000010000000010010001100101100110111000110000011101
00111000000000100100000110010010111001011110000001110010000100011000100000010000011011110110100100000
10010000111001000000001010010000011111010100100000010000000000011000000010000001100100010100011010000
10000000000001010011010001110000000000110001000000011011000100111100011000011000000010100000011000000
10011000010100011000101000110010011000001001010001000001001010100101001001010000000001110110001001100
00101000000100001010001000110001101001100010101000100100010001101000110000000100001100000000100000100
01000001000100000000100001001000001011100010000101000001100000000010011001010101000000110000100100010
11010110000000000100000000000000000000000101000000011011000000100010000001001010101001001110010100000
01000000011011000000101101001111000000001001010011010001000100011010000101000001000010000000011101000
11100001000000110011101011000000100100000000110010010000100100110010000100010000010001011000101011000
10100001000010000000001010010011000000110000000000001011000001100010000001000000010111011111000001000
01100010001100100000001001001100001100010010011100101010000000110001000100011000000100100000011100000
10000100000000000000000001000000001011000011100100100001000000010010000100000110000000000101001000000
01001000000000100000000010000001000001000000000000001000101001111001000001000100000001011011010000110
00001011100100000000000001000000000100100010100000110000100100000000011000111100001000011100011101111
01100000110001010001010000011010000001000100001000110000000010000000000100010101001000010000000110111
01000010000110100100100000000000100100011000000010000000010011001000100010100111110000000000001111000
00110101000100010000001010100101000010100010000000101100001000100000001000010001100010110111010100100
11101000000001001011001011000000000110110011001000011000011100011000110000001000010010100100011010001
00010010000100000100000000010010011100100100001000001001011100010100001001010100011000000001000000000
00010100000000101000001000110011001010111000101001010000000100000100000000000001000000000011000010010
01010001000000000100000000111010100010100000010000100101000000000010000000010010100001000001011101010
00000000100001010101001111000001000100000100010010000000001100000010000010100011001001000100000100000
10010010110100000100111010100000000000000000000000101001100000000011000100010101100100000000100011000
10100101110110101000100010101001000000100000000010100000110011000000001000100010110010000010000000100
01000010000110000000110001100001000101010010100001110000011000100001001100000000000110000000001000011
00011000100010001100100010100011000000000110000100010000100111000000101001001000000000010001110000010
10000000010000010000001101100101000001100110000010000000011001101000000010010000000010010000000101011
10000000000001000001000000000100000001000000001000100011100000100100011100010100110100111000010010100
01010101001000110000000010001011000000010101000000011000100100000110000010101100000000001010001101001
00000010100101000000000001000110100100001011000010000110001001100100001100100100001010101010000010000
10100001010010110101010100000000001101110000000100000110000011000101101001100000000000010011100100000
01111011001000001110001100000111000000110000001000001101000110011000000101011001000011101100011100101
01100000000011111111110011100000100100001000000010100101010001010011010100010001000000001000111100000
00010010010100100001110011000000000011100000001000010111001000110011110011001010010000010000000001000
00011010011000001010000000010011000100001001111000000000000000000000001110000110010011000100000000110
00010001000000001111011010000000010000100000000001010000001000100010110000000101010000100010000000101
10101001001000000010101000101000000010100101000110010011110000100001000010001010010000101000000000101
10000100110000100100000100001000000010010001100010100000000011111001110100000100000100101000100000110
11111100000000001011110001010000010100100111110001000010001110001111110000101011110100000000100000011
00001010100011001100000010100001110101010000100000010010000000001100001001100000000010010001001101010
00100110100000010001000000000000000000000011001100000000100010010000001000000011011100000110000011000
01111111001101000010000000010010000000100000010001000111100000100100110100100010000011001100010000111
00000000011100110111000010001110011001000001010000000010011000011011000110000000011111011011010000001
00100001000101010110000100000000000001010110011000100000100110000101010000100000000000000000101011001
10001000010011000010000000000010001001010110001001010110000001000000010111101000001101001001000100101
00101001101000010010000100000010000100110101000010000100010010100001100000001100100011010010000100100
01000100100111001100100000000000100000100000000010011001100000111000110000000101000000000010001001000
11000000100011000000001001001000000000110000101101101110000000101100001001101001010000100010101110100
00001010100100000100110011100111000101111100000000000100100001100010100000000100010011000011000010000
00100101000100011010011011001101000100100011100001000101010000101110010010000011010000001010011001100
00001001001001100011000001101010000000000000010010000100001001101101111110010010010010100000110000000
10011000001000111010000111100100000000000000000010010000001000010011000000000000001000010000001100001
00001010100010100001000000000000000100010110010000000010010000111110000000010100001001010010110010000
01001010100001000000001000011000000010010010001000010100000000000000101000011000000000001000110011000
01001000001011000001001011000100001100000110000000000100001000000010010010000100000111000100011001110
00001011010010111000001100001110100000010000000101101111000110000100100100001001000010100110101000110
00010000000001010100010011011100000110000010000000011111101000000000011000000100000010011000111001010
00011011001000000100000101000000001001010010000000101110001111000000110010001011000000000001010110100
00100100101111000100010010000000010110101011001001101000000100000000000100011000000000110011011000000
10000001000001111000000000000110100000101100001011000000100000101000110000100000000000110000010000000
00001000101000000100100000100001010010000000001101000001000010000000001101110000010000000001001100100
00000000000001000011001000000100010100101000110101000100100101000100110100100000001000101100000000000