78,38
22,41
00001000100100101001001000000101100011100100100000000000101011000100001001010100000010010100000000110
00000100000001011010011000001010100011100110010001001001100110111000100010000000110000010001000110001
00000000100000000000100000010000000001000000100000000101010001000101010000010000000100011010100000010
00010001100000101000000100100001000000000001000000001101100010000010000001010011000000001000101001101
11000001000000100110000010001000010000000100101010001100100001000100001101110000000101010000100010000
01000101110011001010000111001000000010111000100000001001000010000110001000000001000000000000001000000
10001000110001001000000000001111001000001110100110100010010010010000001000000110010001010101000001001
00001000101100011010001011100001000000000000000000001100100100101001000000101010010110001010000100101
11000011110000000100010010011100110101010001001000000011010000001110001001100101000000010100000111110
00000000001001001000010010010000001110010111000010000000100010100110000001001101100100011110110100010
11100100100001101101000100110010010011110110000000001101000001001011100011000000100000000000010110000
01001000100100000110111001001000101100000110001000100010001010000010110100001001001001010000001111000
10000010000001101001000100011010110100001000101100101000000001001010001000110000000010001001000100000
10100011010010011000010000000100010100001010100000000000001101001010000001000100100010010000000100111
00001000000001000011001010101000011101000010010011010110000100001001000000000001010000000000010001000
00000111010100010001000000000000000010001000101000110011000100011000000000001001000000100101100011100
00000011010100010011000100000101010000000110101000000000000010001000000011000001100000100000100000001
01000100010010100111010001011011101010001100100001111110110100000000000010011110001010000000100100000
01010110011000000010000010000100100010101000000000010110101000000000000110101100010000000010000100000
00001001011000101000100001100000110000100100010100011101000001010000101000110001111011101000110100001
00000110000011000000010100010000010000100001010000000110101000000000010001000010010111001101000000000
00100001000000111000000011000100000010010010000001000000101010001110111101001110000100000001001000100
00001001000100000011000000000001000001100110000000011000101010000010011001001111000100010011011000110
00111000001001110011111000000001101000110000100000110000100000000000110110101000011100011001000100010
10001001010000000100111000001101010000000100000110000101001000001010100000101010010000101000110010011
00110000000000011010000000000001101011100000011101000001000001000100100001001011100000011101101010100
00110000000100000111010010110101000100011001001010000001100010001010010111000010100010000111000000000
00000000000101100000100000011000111000111000000110101000000000111000000110101111000010010000001010000
00000001010001001001010000100000000001010000110001000000001100000000010100000001001100001001001000000
01000001000010001101010000000001110000000000001001000000010100010000000101100000010011110001010010011
00101101100001010000100001010100000000000011110000010010000000100000001011110001000010000000000001010
01000010010000011101010100110001100000111111100000000010000100010100011100000110000101001111000000001
00010000110010100100001000000010000100000000010000000100100100100010100110000000110000010000000000000
00001101001110000001010000110100001000110010010100000000011011101011100010011000010001001100000010000
00000000001000000101001010110000100011001010100000011000001100001010101100000000010001011100000101010
01011010010000001001001000010001000001100010001010001010100000110000000010000100000000001000110001000
01011011110010011000110101001000010000110010000011100111000101000000000000001010001000000001000000000
11101001111010101001001000011000001001100001010000000001100000101000011010010110001100100101000000001
10100100000000111000000011010000101000100000001100000000000100011001000100100100000000010000000001010
00001001000101000000000000100010000010000111010000110000000101000011000110001000010110101100000001010
00110101001000000000000010111001100110011100000010011100100001000001001001001000010000100000010111100
10100011010000101001100000000010000100100000001001010110011010100000000010000101110000000111001011010
00000101100000101100001100000010100000000000000000000010000111000010100000000011110100100111000011010
10100000110111100011010010010001101100010010001000100010000010001000110000000100010010000000010100110
01001100100000000110000000110000001000011010000010001000000110010000101100001110011001101110110100000
10010101110001000000100010110101010001001000001111111101000000100010001111010100101100011100000100111
00010000001110000001100001101101011000000001010000010011111101011000000111101000101000000010100010000
00001100000010010010100011100110000100001011011110000001000001000111101100010100010000100100001000001
00000000001100101000110000000001001101000000010000000001010111011100000100101101010001001000101011000
11100100100100111000000000001000111000110101001000000000000111000000110111011010000100000001110001000
00000100000010001100000000000000000001000100110100000000101000100010000100000000011011101010010000001
00001000010000000011000000001001011000000111111001010111010011000011011010011000100010000100001001000
00000001000000000101010011010000010000001000000001001011001001000010000001010000011011010101001000001
00000100000100000000001001011000101001110111010000100000011000110101000000000110000101001000000011101
10001000100001010000000001101001011111010000100000000010100001000000000000001101101000100000001000000
00010101010101010110000000100110000010011001100100000000000110110100000001000010100100100010000100000
10100110100010000100100101001000100110101010100000010000001000000000011110101011110100000000100100000
01010010001001001001010001000010000100101000100000000111000100000000000000101001001000000001100000010
10000000000100000000010011010011011000000000000111001001100000000101000000100110000001101000000001010
11100100101001001000000000011010000110011100010001100001000000000000000000100100001010100000011001001
10101100010001100011101000001010100000010001001101000000100000101110100011001000101101000000111000000
00001000000000010010100000100010000011001001011100110111110000001000000010000000000100000001000000011
10101000100011000010100100000001100100100001001000011010010101010001011010000010010000001111100011010
11011101010000111010001010101010010001011001111010000000001000010000001000010100000011110000010001000
00101000010000001110001100100010000000001000010010001100000100000100100001101000000000000010000000110
10100010010100001101000100100000000010000001010000010110100010011000001001000110001000011001000001010
11000100111010010101000100101111001101100001010010100000001000001000100111000010101101001101001110001
00000000011011000000011110100000001000101100001100100110101000111110100100011001000011011000000000100
01100100000010001010000001010001100000000000010101010000000010001001010111100100000101000000010101100
10000001110001000000110001000000010001000010101001100110000000000100000100010000000101110100000001101
10001000010001010000000100010010000000000000000000100111001000010100100000011101000010100001000001000
01001110000000011101011100100100000000111111000001000101000101000101000010011010011101010001110001000
10010010010001000000010100000000000101101000000000111000001000001000000000000100010100000100000011000
00010100000010101100011010000100001000011000011101100000000001010100010010011001010100000010100100010
10000010011000000000000100000110000000000001010011100010010001000101100010110100001100000100011001000
11000100000000000011000100000010010101100000110000000001110000100001101000000100010100000001110000001
00100000000100000000010101100000000000010010000101000010110001111010010000100100000000000100000101010
00000001101010001000000010000101101000000000011100011010011011011010011000000000010000000101010001001
00110010101000100000011110001001001110010001001000000000100001000000001100001111011000100100011000100
00000111001001100010000000111001001000000001010000000100010010000101000010000000000000000110010101000
00110000000110000000110000100001100000101001001011000001001010011001111000011001000011110010000100101
01100000000000101000010110100010000010101110100110000001111001100000001000100100011000010000001101000
00001001100000000110100000000100100100110111001011010101000000111001000100110000010001010110010011000
10101000010101010011011010000010011010000010000001100110111000000001010101001101001000010000000010100
00001000101111100010011100000100000001110001010100110001110000000001010100100011010000101000000000001
00000011111001100000001101100001000000001100000100000001100100010000100011001001010001000100111010000
00000001101001000000000000000000110011000001001110000100000010101000010000000000100001100001110011100
10101011001000001101001100000001000110100110111110000000100000010101100000111000010001010000001001000
00000010000101111001011100000000000101100000000111010001110100010001000101100100100000000000010100000
00000100010000000010000010101000001001010110000101000100110000100000100000000010000000010100100010000
10111110010001101101000000010000001011001000111000110010001000100000110001000010100001101010100100010
10110000100111000000101000100000001011011010011010000000000010101100101010010000001000010110101000110
00001001010000000000100010011000100000000101101010000100001100000011100100001000011101100001010010110
00000011100100000100010100001001010010000000000001100100000010011000000011100100010100001010000000000
00000000001001000111011111001110000011001001000000001000010100010100101110010011001110010000100000000
11000000000011000000000000010010010010000001001001010001001010000010001001000000111100000000000100011
00000000010100010000110011000110000101000000000000101011000000100000010110000001010110100010111001000
01001000001100000000011000111110001010010101001101000001100000000000100000000010010000111001010010001
00001101001100110000001000001000000001001010000000000010000000010000011010010110000000000111000100110
01001001000010110100010100000000000000100010100001010101100010000010000010101000100110010101100010000
00010001100000000000101000011100010000100010100001100011010001000100101000010000100010000000101010110