86,92
39,91
01001110000000101001010000100101000010010100001000001101100000000001100011111000000000011100001100000
10101010000010100010010101000011011010100001110001001011000000000110000110110000010110000000101001001
11011011010001001001100000001000010010011000010000101001111010010000000011100000011101000011100000101
00010100000101100100010001000001100010001000010010010000001110110000000010010000111100000100001000000
00001100010001001000101001000000001000000000010001000010100001001011110100010000010011111001011110110
11000101010010001010011011100000000111000101000001000000000000000001000010010011000000001011100101000
00011000110010001100001011001011011110000010001000000000010010001110100000101100011000000111111110001
00000100101000010000100000001110000011100110000100000000000000110001011011010011110110000011010001110
00000100010101001000011001000010000011010010000001000001100000010001010100101101000001110000000001110
00000110010000001000001000010010000100100101000000000101001000111110000011000110000000010011000100110
01000011111001000110100010000000010000110010010000001001100000010000010010100100001100000010000101000
11100000011000010001010100100000000111001000000110001001011000110000010000011000110000000010111010100
10100100110001000000111000101001001110000000000101100100001110001000011000000000001000011001111010000
10001001101010000101001000100001001111010000011000101011000100000001010010000100001001011001110010100
00001010011010101001010000001010010001101001010011000001000001001010010000100001010100100001011110011
00000011000010110100001000000000100110000010001011000100001000000000011110000111011001110001011010001
00101001010101100000010110001011000011001000000010000000000100000100000000101100100101000000010100100
10000000011010000101001000010000001001111111000001110000000010100010010101100010010001010000101110000
11000111001011011100001001010000000110001000000101000000000000101110010011000000101000100000000001101
00100001100101000100000100110001001010110011111001100100000011100100000010010100000100110011101110001
00000000001000000011000000101000100000100001000110000000000001000001100010011100000010011000000110100
01110010000001000011000000000100111001010111100000000010011110000000000000101111000100000010000101001
01100000001001000000001011000110100110010000100000000100100011000000000100000000100001001000100000001
10101010001100000000000000001001100000001001100101011010000101100000010010000000000000000110111000101
10001001010010010011000010000100001101111100001000000000000101000010110000000001110100000100001000100
00000010010000001010010001100010000000001000000000100001000011100000110000011101000001000000000010100
10000000011000010011000010001110100101001100011100000101000111010001000000010010011010100111001000000
00010110110010100000000010000100011000001000001000001001101000011000010110001110100110110110000110100
01100000100000101010011000001110000000000001001000000110101000110100110101010011001000010000100000101
10000101000100000100100000100100011001110100001000001011001001100001010000000010100000010000100100100
01010110000100110011000000000000000100101000010010101100110000010001000001000100010101000001010010000
10111001000001011001110000010000000000100000101100001001001010011001101010000000101010100001101001000
10000000000001110000000001000110000110011110000000000001110000100101010100010010000000101000100000110
01101001000010011100100000000000001000000101010000100000000011000001010101000000000000000110100010010
10001100000100010100000001001100100000011001011110100000100000100110000000000001000001010000000010001
10001000100100000000101001010010001010101010000000010111001010000000101100101110000000010000110010011
01010010101011001101000000001101000101000001100000010010001100010000000101100110010001100000100001110
10110111110000101011011100101000000001010010001000000000000101010001010000100110001101100000101000001
00001000100000010000100011001000001010010000000000001001110010000111001110101000100010100000000111001
10100000001100110010001101000000100110010100000000100000010100000000010110011000001010000110100110000
00000000100000010010000000101000011000100011001000101000000101000000000110010001000000001000101010100
00000100110010001100100110011100001000011000110101101100000000001000000000100011000000000010111010000
10000001011101001110110110001100000101001000100100001001110000010100000000111101000001100010011011000
01110100100000000000000010110000010000110000000100000000010001110010001100000000100110000000000110010
00000001001001100111111001011101001010001010101010000010000010001100001110000111000111000110100010000
10000010000000000100100010000000110100000010101011010000001001000100100010100100101011000100110110101
01100000010011100010111010100110011000001100000000001010001000100010010100010110100011101000000000000
00000001011000001011000000000011000011000100101000000000100011001010000000000000100000010000000000001
00000110010000000111001010101000100000000000000010010000010000001101011000001100000100110100000011100
00000011110000101010011100001101000000000101011110100011001011111001000000000010011000011000000000001
00010000011000011100001000010011000010010110010000001000111000000100001110000100011000000010001000100
00001100100010101010001001010000100001010000000000010000100000000010110101000000000100010000100000010
00001010000000001110000000101000000000001100000101000000000001000011010101000000001010000000000000000
01011100000010001100100000000001000000010100001000101000000011010000000000000011001000000101100010000
00100000000011001001100010001001000001000000000100000010110000100100010100010000000000100000001001000
00110001000001000010000100001110110001001100001111101010100000101000010011010010101010000000100000000
10001000101001000111000001000001000101000110001000000011000001011110100100101000101000001011100010000
10000001000001000110001100000000100100000011011110110010001110101001010000100100001011010001101000000
00010010000010000000001110000010000101010100100010001001000110000000001000000110011010100000010010001
10001001000000001100000011001100001010010001000100000101000000000000000000110000000000010001100001010
11100010111011000000110101010101110000001000000000100000000000101011000000000100111101001001100111010
00010100000001100111011001101001010010110001100000010100010100000100101000000010000010000001101110100
00101000000011001000000110011000010000000010101011010000000000001001101000010000100100000010000000000
00001000000001010010000001110000001101011010010010000011101010110011001011000010001001110000011100110
01001010000000010000000110000011000100100111001000000010000001000101101111001010000000001010000100111
00000000000001101000000000000110000010110001000010011000100000011000101010010000000101000000000011000
00000000010000000000010111000010001000000010100010100101010000000010000000011000010001000110001010110
00001000111110000000001000100001000000000001100101000001010000110101010011011000000010000100000001010
00011000100100000100000001010100000000010000000110000011001110101100010000100001000110000011001010000
00101001101100100000010000011010001000000000000001000000100100000110010001000000010000000101000010000
00000000101001000010101000010000000000000000000000000001001110001000001101000100001000010000000001100
01101110000000101010100010010110100000001010001010011111000000001011010011110000100110101010101100110
00101010010000000011001000000000000010000001110010000000000100010011000010000010010111000000110001100
00000001000011000010001110010111100100011000111001010101001010000000010001001000000110101110100010100
01100000010110000000010101000100010100101101011110110010100100101001001011100101000000100011001000101
10001000010000000010110100001011101111100000000110101010000111110000000100000000110111010100010110100
01100101000101101000000000000100001100000010000101000000001010110110001001000000000011000001001000000
00001000101101100010000011100000110100000010010110110101000111110110100110000110001000010100000010100
00000000010001000010000000100000001111001001000010001100001100101000001100010000000000000101001100010
00100001101010010010100000001100000010000110001100010100000000100000100000110010010110000011100100100
00100000100100010000000111001010000011000001010000000100010000001010001011000011000100010101100000010
00000011110000010010000000010010001100001011101000010101010111101000000010000000011000000100000101100
11111010100000010000001000000101010100110110000000011100100011100000111011000101011111010000001110111
10000101101101011000011011010000100100110100101001011000001010010100001000101000100000010010000001000
10001000011000000000110000000100000000001101001011110000100001101101101110000001010011000100010000100
10000000011000011101000011000100001001001100001011000001100001000000000110100001000000000100001000000
10001000100100000011000110010001111000000011000100110111100000000000100001100000110000010001010111101
01100011101011000000010011000011011000000010010000001101100001000100101010010000000001100000000100001
11010000010011011100000111000000110001000000000001000010001010000111000010001101100100100111110100000
10000001000101101100100110000001011100001000100011000101100101000100100000001100110010000001000111000
00100001100000101100101000000110110001001010011010000000000000100001110100000000010010010000100000000
00001000100000100000000000000010101001100000010001100100001000000010000000000110010100010100010001000
00010000000000000001010001110110100000100001101000001010001011000110000001010100001010001000100000101
01001001000010010010000011000001000000100001000000000110000100010011101100101001001101000000000000000
00000110000011000000000100000000000100000101001111110100001101101110100000000001100000000010000000100
00010100010010000000100100000001001101000001010000110010000000101010000110110101000010100001001100100
10100100000000101001000000010000000000011101000100000110101100000100001011010000000010000001101110111
00001000000010010000001001011011000111001000110010001000000011010010010100000101000000100010001100101
01001000000000000101100001000000110000000000000000100000000000011000000000001110110000000001001110001
00001001010100000000001001010010101101011110001000010001101010100000010000110001010000100000110000110
01100011001100110100000000010100000010100000000010000010010011000100011000010011110000011001000100010