46,96
73,31
11001000000010000000000000000000100000001000111011111000011010001000000000000100010101000000000100100
00001001111000000001000110000100000000000000111100000101001011101000000010100000101011101100110011001
01011001101010111000010001010010000000000001101110011010010011000001011001000010000000010010100010000
01001001000000010110101011010001000110000001001001001001001010100001000000000000101100000001000100010
00001001000110010011110000000110001010001100110010001001000110010010010001011100000100110010000010000
00100000010000001000001000011100000010000010000000001011000000000101110110001000001000011001000000101
01100100000000000000000000000000000011110010010101011101100100010100010010100110101100011001000010110
00000100000001000011001010000000100010000000100100100110101000000100001110100100100010000001111000000
11000110101100100000001000010110000100010000101100000000000011000100010011110010010000010100000000000
00100000010101010010100100010011000000010010011100100010010110000100000000000010000010011001111000010
00100001001001000010000010101000001110100101000000000100001111001010010000000000000010000100000011101
01110000100100100010000100010000000101000000000000000000001000000100000011010101010101100000001000001
00100110000000001100111000000000001000000000100000000110001110100001101110000010000000101100001100100
00110001010000110100100001000001000100000000101000001011010000101110010010010000000010010000100001101
00010000001100010000011100000001110010011000010100110000111000100000000111000010000110111100000000100
10001000000010101110000000100000010000010000001110000000100000010010000100111100001010110001001101110
10001000100010110110111100001000000010001000000101010001000000100000110011001010000010000000010000010
00000011010001001111000110010011010010000000000000110100100000010010101100011100111010000001101110100
00000010001111000000001100010101000011000011010100100100000001000010001000100011111001101010000000000
00100010110001100000000010000000000011100001111110000100000110010010110010010001000010010000001000000
00100001010000101000100100000101111001010000010010000001100001001010000000001100000010010010100000100
10000011010110001101010100000000001000000000100000000100000100010010010010000011011000000010010000010
01000000011100000000001000100000000000000010101010001010000100000011101000010000001000001001001000101
00000000010000001000000011100001000101100010010001101001000101000100100000100011101000000100000100011
00010000111000100100001110100011111001000000000110001001000000000000000100010000010010000000001011100
00110001000001110001001100010000110000000100101101010101000000000001111000000101100010010000010001000
10001000110101101011010111100000100000110101001100000001111000000000001100010000001000001110010011011
10011101000001110001101100110100110001101110000000110111010100101000101000000100001010010110110000010
10011000000001000100000001111001101010101100100000000000000100110000000000000000010010011000110101110
10001001000001100010010100000001001100001010101001100001000000000011000100000000001100000100110100010
00010001000100100010000000010000010000001000000100001000010000000100010010000000000010001100000100000
00110110100110101001011111010001010000000001000100000000000010000001000100100100000001000000011111011
11001100100010100000000110000010000011001101010100010000001000001010000000100001001111001000000000100
00001010000010000110000100100101000000000000000110000000000011000111010000000010010100000100000000000
00000010000001000000110110100000010000001101000000000101110011000010000001000111111000010110100010001
00011000110100000000000111000100100000000000100000111000001011000010010100111001000000101000110001000
00100001000100001000011000110010010100100001100000001001000011000000011001000010101000101000010000000
00010001001011001010011001111000100100001100000100000001001000100010000101001110110000000010001100000
01101110000000001001100000100100011010100001001001001000011100000000000001000010111101000000100110011
00110100010011000101001000000010001100100000000000000010000001000100101001010100010001100101001011001
00001100111010000100100110110011110010000000001010000001001100100111100101001011000001000000100001001
00001011000100010000110000000000000000000010010000000000000100011010011000011101000000010001100000100
00000100000010100000010000100010100110010010110000100000101110010000100000100000000110011101111101011
10000100010000110000000110000100000011000101010010000100000000010011000000001110110100000000100011010
11001101000110101011000010100010000000000111000000100010100001000000001000000000000110000000010000001
00001001100001100000100100001100010000000100000000000001010000001001100000100011101000000000001110000
11001000001010001001100000111000100000100001101011010110001000010011000000000100110001000001010101000
10011100000011100010100000101001000001011110000101010000110010011001001100110000000001000011000000001
00000100000110001000100001001000110000001010000000110101000000000011001100001001100010000001111000101
01100001000001010100000010001100100000010010011000010000000000111110010000101000000000100100010000111
00000001110111001010001001010000101000000000000000100011100000010001110001001101100000001000000000100
00000010000000000011101000100100000010011000101000000100010100001001000000010110110000010010000000101
00000100000100000100101000001111011000000000000001000001100000011000001001100000001110000000000010011
01000010000010000100010001000000001100110001010001100011000000001010101000000100000000001011000100000
11000011000011001110001000000001101000001010100111001001001001001000001100100000001000100110000001100
11010001110000000000100000000001000100011010100011000000101100000000011000110000010001001000100011100
00000011011000001110001101010010000000001000101010010110100000111001111010101001000110000101011001011
01010100000010101100010000010010010101000111000101000011100010001010100001001000001001101010100010000
10001010001010000000000001100100001011111100010010001000010001000000000100011001100010001011111001100
01001001011001100000000000000001100100111100100000110000101001010000000100000000000010001000010001100
00001010000101100110100010001011100100000011100000010000100100010000000011100110011000000001000000000
10000001100100111001011000110001100001001000010000001000000000100001110100100111100000010000001010011
01010001010000010000001010001010100010100101010110100110011010100001010000100000101010110000000010000
00101010010000010010010010010101010001010110011100100000011001100100001011110100010000010100001011000
01000010000100001010001100010000101101001000011000101100000000001110100100100101010001100100001000110
11000000000110100100000000101001000111000100010100110000000000001000000001000100011000000000000000110
10001000000101000110000000011000010001011000001101001001101001000000000001010000010000111000100000000
10010001100110001000000001101010010011010000000000000110000101011000011000011010010101010010110000001
10001010001010011000001000000010000100100000001100100000000101010011101011010010001100010000100011001
10010000010000000011100010010010000000100001001101101110000000000000101001000101101000100011011110010
00000100000011110000000011001000010011010010001010010000101001100011000000100100000000000000001001001
11001000000100000000001100010010000110110001000010001111011011011010001110000110000010000110000000000
00101001000000001101010110001000000000001100010100100000010001001000100110100001001000000001001010000
00110001100000000001000000100000100000000000000100011010000001000110010100110010010100100001000000100
10100001010011000100100100000000001000001000000100001001001000100110010100000100101100110100011000011
10000010010000000000110010000110100000011000001000000110010000000000000000000100110001000001100011100
10101000000001000100010000010011101100100001000100100000100111000000010111001001001000000011000101101
01001000100100111100100000000001000000100010100000110001001000010000100000000100001000100001000101000
00000110000000111000011000000110011001010011000000000000001010010111010000000000000000000000010000010
10011100100100100100011111110110011000001000100100001001000000010010000111000100001110101100001000000
01011110001001000010000000000101000000010101010100001000000100100001110000000001100001101001000100100
00001000010010100000000000001011101001100000000110000010000010101011100000110111001000101100101001101
01010010000101010110000010101001100001001010100011100111100010000100000101001101011011101000000101011
00000000110000100100001001000000100010000000100000111111111100000110011000000010000000100101000001111
11000000001001001000110001000010000100000100110100000000000001010110100000000010001000100110000001100
00001000110001100001100001011000100001000001000101000010000001100011000000000000000001001100100011001
00110110000001110000000101000001100000000101011110000010000111100000000101000110110101001110000000000
00011001000110011100100000000010100000000000001100000001001010010101010000000001001001100000000110000
01000000000000100000111000000100010101010101100110000000000110000101001000001010001000000001000000000
00010100000010010010001001000010010101010000101100000000001010101111110100110101111000010100001000000
01101010100001000011001100000100000001101000100011000000010000000011001101111001000100000001001000100
00010010000100001001010001111010100100000000000100100001011001000000000001100010001001011000001000100
00100000010000001110010010000000001000000000000000000000010001011000101000001011000011010000000000001
00111011000011000000000000010101000001001010100110010001000000000100100010101001100000000000011000011
10000010001000001010100001100010000000000011001101000001010101000011110001000010000010110000000100101
11100000001010101100111101001111011000000101000001000001000100001000100000111000000001100011000000101
11010110101100000101100100101011101000110010100000000001011001010000010101000000000001100100100011000
10000000100010001001110000000101000000001101000001100010000100000101111010100000100000001101100100010
00001010000000110000001100011100111100111000000000100110101100110010000010000010001000001010001100011
00000010001100000111100100000101100010011010110000000000000010000000001010000101000001011111001111011
01000111010001000000111000010001001101001000011000000110011000000001001001010000011101000000010101011