76,51
80,50
01000001000100001011000000001000110000100000110000111001001011100000001001010001000000001010010101100
00000010001000100000010101101100001000010100000010100100100001100010001110010100100111011000100001000
01011100000010001101001101001000000001010110010100110000000110010101010010010011000100000010010000010
11000000011000010001000110000000010010000000010010110001000110010101000010100010001001000001001000000
10000000111100000100001000000000010000111001001000101000000000000001010000000000000101100000000100100
10000110000100100000000100000111100100000010010111000000010000000000000000000000000000000000000010110
00010001001000111010101000000110101000000100011000000100000111010000000000000110100101000100100000000
00000010101000010001111100100000010000111000110010100010001100000000000101110101010101001110100100000
00000000001100100000010001001100110001001110000001010010010010000101001110010000000001000000000110110
10100001100000000110000100001100000100111000110010010110101101101000100010010111000000010101010010101
10101010111101001110100010001110000001010000000001010001010110001000001000000000001001001010010100100
00000100100100100111010100001011010011000000010011110000100001000110010001101000010010001000010001001
00100000110101100110011100100001100000100110001101000100001001100000100000001001101001000000001110000
11010101010000101000100000110000000001101011100101000000000000010101000000000000000000000001100100001
00110100000000011100001010000000000100000000111010110000000011010110100100100110010010000110001010110
00100100100001000001000010000110101000100110001110000011010011001000001010001000010000001000000000101
01100111001000000101010010010001000011111001001001000101001010111110000101100100000101010110100010000
00101000000100000100000000010011101000100010010101010101000010001010000101010010010000000110000010000
00010010100101000010000000101000001001000101101010100000000010000110001001000000001101100000001010000
01000100100111001010010000011000001010010000001101000100100000000010101100011000001110000000110000001
10000101100001000000001101001011000010001111000011001000100001000010100100101000010000010000001100000
00100000000010011100001100000011010000000001100001000011100111011010010110000011001100101000001000000
00100000110001000000010010110001100101101101000000111000010000000000000000000001010000110110000010000
00010100100001001011110010000000000001000001000000111000001001001000000100001101001100000010000000111
00110110110000001100000001010100110001010101000011110011100000110010100000001000000100101001111111010
01001010001000111000000100001110000011001010001111010010011010010000000110001000110101000010000101001
00000000001010000110000000001001100100100100000100100000000000010001001001000100000000011100110001101
11000100001000101000100010001010100010110001010000011100001000010111100110000111000100000010110010000
00001000110000001010000000000000010000100001011010000010010010110010000011010100011011010001000001011
00001101000001000001010110010001011000010000110000000101000000010100010001010110010001100111100110010
11100100000010000100000011100100000000110100000000101101001010000100000010100000001010110110100101000
00000000000010100001101000011000010101100000100010001001100000010110000000110010000100010001110011000
01000001000000100001100000000000110100100001100000101001100000010010010001010100100000011000110100101
00001001001011100000000100000100011010100011100000111100011010101000000000000001110001010110100001000
01100110011001000011000000000000010000001000000010001100000101101000011000100010000010100101010001010
01000000100001101000011010000001010000100010101010111010101000001100010000001110001110000000011110000
01011001101010001010110100100000000011010000000010010110000101000100001000001001110011010101000000000
00010000010100000010010100100010111000010001100000010000000001000000100100010101101100000100011000000
00000001000100001001100100000100001100000001111110001100000000000001111000100011000001000010011110000
11111100000110000110010010101000100000010001000001110000000000000000001111001011011011000101000101100
00001000101000000101110010100000000000000001000000011000011011010101100000100100100101000100000110001
10000001000010000110101010010100011010010000011000100000011011000000000001010001100010100000101010010
10010010000000010000100010000110000000010010100011000000000100001011011100010010001000000000111100000
00010001100001000001101001101010001000101010010010100100000010000100001010001001000001000010101001000
00000000010000000101100010100101110010000011001001000000010100100110001101010010001100111001100010010
00011000010011000100010000100000000001001001101000001000011101000111010100010010100000010000100000001
00001000000010010000001001101011011111010000100100010110000001000010001010001010001000010001100100000
00000010001000010010010001111110010110000110000001000110100000001010010011011111100101011000000010000
00001010010100001001000010000010000001100011000100100001000000000011000111100010100101000000100101110
10000000100101000111000000100101011101001101110010100000100000000000010001010000001000010000010000000
00000010011101000111010000000011100000100001000000111000000100000100001001000000011010111110100011110
01000100001011001011000001010001010010010000100001100001000101000010001000010011101001101100010000110
00100001000000000000001000010001010110001010000000001000111001000000000001100010000101001011010010000
10011100000000100001000010110001011001110011000000000001110010111001000100001010001010000011000011000
11000000001010000110000110011000000000000110001000110010001010000100001100000011010000010000000100100
00100100010001000001001000000100011011101000110011000000000100010000100000110101100000001000000000010
00000000001000110101100101111000100100011010011000000101000000010000010000000010000000010011000110001
10010001010001100010001100010001000010001000100000000000000101001000000001001010011011000101000001010
01000000010101010000100000000001000000001010000100000001001111100100000000010100011100010000000111010
00100001110000101010001110000001000100100000000001100111000010000100001011000100011001001000000010000
00000010100101000100000000010100000000011000000010111111000010000101000011000100010000010101000100000
01000000010000001000000001000000100010000011000001000000000101100000000100100000011100000000000110001
10000010010000000000000000010000000100001111100000010100100111000001100000110010010111100100100100001
10010001011000010011100001001000010010100000010001010000000000100000001001100000001000000000011100110
10110001000000000110110000000000010000000100001100000011100110010000100100100010001100000000011000000
10010000100001001010001101000100100100011100011010001000010100100011000001110001100010011100001010101
10000000101001100010000000001000100001000000100100100010010110010000010001101001011011100000000100010
00010100000000100110010010011011011000000010111000001001011000001101000010000100000101001000000000100
10000000011101001000100010000010000010100000100101000011000100010010111010000000000111100001001100010
11010000000100010000100000001001010010000001000000011111001100010000000000000011100000101000011000000
00001000000110000000001100100000001000100000110000100000100010100000010000000100010000101100000000001
00110000010100000000010100000101100000011101000100100011110001001100110000000011000100010000110100000
01001100011010000000110100010111111100000000111000000000000110000101100010101000000011100011101000000
01001110101100011101000001000000100000000000111000101011000001010000010101000010010010100000001010000
00010001000000100111100101000100100000000000001100000101000101000001010000000000000010011110010110000
01100000010100000000000011010000001000001001101000001000001000001001000000000100000101101110000001110
00010000000000110000000000011000100101000010100011001100001000011011011110000100010101000001010100100
00000000000110001100001100110000010100101001100001001100001000000010001100000100000001001101101010101
00001000001000001011010001110010000000000000000001001110011010001011010100010111010001000001010100101
00100000100000010000000001010000001000001000000000100001000010100010100001010011010000000000110001010
00100001001100010000101010001000100010000100101111001000000001010000000000100100011000100100000001000
11010110010100000000000110001000100000010001010000000010010010000101000001110010011100001001001100001
00010000011010000000000010001000010000010000100000110101000001000001000000010100111010000011110101100
10000100000110010001100100001110100000100010100001000001101010000111000001001000000000000100101000100
00011000110000000111100100010000000010000110010101110110010010100110001001110000100000000101010001111
01000011101010101000011010000000000100001010001011000100001010000010110001100010000001001101100110000
10001000000010000100100010000101000000000001010000111011101000000100001001000011101010010000000000100
10101000010100011001000101010001000001010010000100001000000011000000000001011000000001000001010111000
11000001000011010010100000000000000000011000000010000101000100000000010001000111100000010111000000110
01010101000000100000000000000110100000000011100011011010000000000101000000001101000000110100100100100
00011011000010100111000000011000000100011001010000010010011101000001001001000000010010001100000011010
00000001111010010010000111101000110010000010000001010010101110100001011110011100100011000111100000001
10001100010000001010100100000000000000110101100000110000110000000011000001001101010000000011001000010
10101000100001011010000001000010111011100010010100010000100000000011011100010000000100001010001000001
11010110100100101010111111000000010000000100001010100000000000000000100100000110011000011001000000000
11000001000011010001100010000011000000000010001011000111110000110001000000010100000010010110000110000
10110010000101000000000100010000100001100101100001000000100000010100100100000000000000010000100101110
10010100001000110011100000000100001000110000000111000110000010000110001000000000111011100100001010000
00010010000000010011111000010000000000011000000000100000001100001010011010101001001100001000001001100
10010010000000001110000000111010000000100010110000001000001010000000001001000011111001000010010100100
10100010110111011100011000010101100001010000001000010001110010011011100010100110000110010001011010001