28,90
45,7
10001010000101111001100000101000100000010000000110101010110001000101000100000100100010000010001010011
01001001100000001001110000000001001000100001010100001110100001100110010000001001000000000000100010100
01000000110000100110000010000010100000001000000010000000000001011010001001000000010001011100011100101
00010110000000110110000010011011010001110100001100010001001000100000010001000000001001010001000001111
11101001000001100000010100000100101111000100101000000100000101000100111001011000001100000101010100000
00011001001000111100010100100010101000001011000101001110011000100000100110001001001101000010000001000
00010000110000100000011000100010001100011110000100000100000101100000010001000100000001000000010100110
10110011001000010000010010000010101100001010010100100100011100000000100001000100100001111000110111000
11000001010100010000100000000100000100000001100001100001001101000000001000010010001011001100001010000
10001000000010000000100001010000000010000000000001000001000001101110100010100001100101001001100010100
00001111011100001000010001001110100001100000000010100010000100101000000001010001001000001000000010110
00111000000001100010000101000000100000100001101000100001000001100000000000110011001001011110010010000
01010100000111000010100001001010100000100010000000100010000000000010011000001101100100010000000001000
00100010111000000101000000001000000011110000101001101100100000100101111010100000000000000011100100010
00111100100000100000000001010000111100011100101001100001001000100101000110101000100101100001000001011
10000011001111100000010001000011101000110010000010000000000000010100100011100010100100000000010001100
11101000110000100000000100010000000100100100100100010000000010000001100000010110011000010010000001100
10011000100000000010100000100001001000001000100100010000101000110000010100010110000010100000000010110
10000001010100001010001000110101000000100111000000000100100000111001000110000000000101001100111011001
00010000110001110101000001010010011000101000001000011110001001110000000111010100000000100101110000101
10011101010001100001000000011011001001100001110010101000100011100000110100000100011010011000001111000
00000001001000000010111000001011000000001001001101101100100001101100010101001001010001100000011000000
00100000110001000100000101000000100000000110010000000010111101010011101000010110000010100001110000000
10000000000000001111010100100001000000001111000000011010000000010100100000110000001000110000110000001
00000101001000000000010100110000001000000001000000000100010001010001001100010011001001000000000011000
01100000001001101101000010001000000100001000100010100100000101001000100101111000000000000100100010001
00110000010010000000000010001000010000010100110000011000110000000110111000000100001000000000000100001
00000000000000000000100000011000000110100010000100000000000101100000011001000000110000000000001000011
00100010000100101010100001001000110010000110010000011011100000001001010001000011010110001000010001010
00011001000000000000101010000001101001000001100111000000000100101110000000000010100001011101000000010
10010001000100100001000010110000100101001000010010001000101100101100000100000000000011010000011100000
10100000001000111100010100011000000110010111010100110001001011100000000000000000000100011101010000000
01001000000000000010000100010000110000011010101000000000000100000000000000011011100011000100011010100
10010000000010100001000000000000010000100100000001110001000001010010101010000000001111000100011000000
00000100000001100000000001010000001001011001011001000111000000000010101101100000000000000010001001001
10010100001100101001000100000001000001000111001011110100000000000000100000010110000011101010111100101
00101000101001000000110011100100000000000010001010111101000000000101000001000111010001001100010100000
00100001100100100000100000001100001010010000000000011000000001000001001110100000101000101000000010100
10110110010100110110100000000010010001100000100000011100010100100100001101000010011000100110001000000
00010110000100001100010010100000000010000010010100101000110001000000001001010000001001100101001110101
01110000011010000000000001101110000100000010001010000000101011000000010000000001000010000001100011010
00100100101000000000001011100000000101000010010101000100001000001100101110000001000000000100000100011
01000101011010110010011000000001100110000001000001000000110001010100011000001110000111010001011010100
11010100010010000001110101010001010001000100001110000110101001011100100000010000000000111111101001110
10000000001000010001000101011000101000000011101001010000000000001000011001000110000000010001110110000
00001010100000100000001000101001011001000001001000000001000000010000100000010001110000100001000100000
11000001001010001100001100000011100001001000010001100000001000101100101011001000010111100001001000000
11000000100110011110000000010101000000100110000000000010010001010001010101000010010101100110000101010
00000010010001000001001010001000000000000010100000100100100010100000000100010100110011011000100000011
01000010000010000000100000001010000101100101010000000100111000100010111010000000011101010011000000011
01000000100010000110100001001000000110000000001000000000100110011001010111011100010001101110001000010
00101000000000000001101000111011010000000000111000100111000000000111101000000100010100000101001000100
01100000000001100110000000100001000000010000000000100000111110000110111011000011001100010000100000100
01000011000100011011000110000010000000011001010010010100000001000111001100010000100000001001000000100
00001001100000000101010001100000000101000110110010000100010001100001000100100010000000100010100001100
00000000010111100001011000100100000101010011000011011000010010100111011110100010001000000010100100000
01000000101000001000000000001111101010000001000010001011000010110000100010100000000000000000000000100
00010110101100010000001000010110111011100000100011000000111010010001010000000000000111000100000000000
00000011010010100111000000011000010001110010001100011100000010000000000100010000101011000110000001000
00010100000100110000010000110001000100000100000010101100010010000001100001000101010001001001000000000
10011001010000000001100100001111010000000000000101000001000000100011001101001000100111000010100100000
00110001101111000000011110101000001111101000000011001111010111001000100001100011001010100011000011100
00101000000000001000000001011000100110101110000001001110110101001000110000000101000000000001100000000
00100101001000000000100110001000000010100001000010010000100010000000000001001110010010000000010000000
00001001000000000000001101011000010100000000001100100110010000000100000010100000101100011000000001000
10011000111110000001010011010010010100000100101010000001010010110000001000000000100100100110110000000
01000000110000010011100100110100000000000001000010010111010010100010000010000000011100001010000000100
00010001001000010110001000001001000010000011100010010110000100000000001000110001000010000100000000100
01011000010000111000100000011000101010000001100000000111110000010000000011000000000100001000000010000
00011100001000011100000000110010011010011010000001010100000101000001001001011010101000010100001010000
00001000000110100000100001101010001000010000000001000000010000000000011111000110010110010000000010100
01001000110000000000000100010011010000000010000101000101001001110011101010011100001010010000000011001
00000000000001011010011010010000101000010000010001000000110101010000000001000010000101010100000000010
00000111000000010000001000000101111000000000010011011001000000000110101000011000000100100010100001000
00101001101100000000100110000000000010000000100000100000100000000101001001110100000111001010000111100
00000010000101001000000111100000101010110001000000100101001011111000000100011000101000010110100001000
10100000000000010000101010000010100000000001100000100011000001000000010110111000010110000100010000000
11000010000010001100000010000000100010000010000000001000000000000100001100101111000000010000000100110
00001001011000101010110101100100011001110111001010011010000000011010000100000000001100011101000100101
00000010001101111000000100101011111001000100000101000000010001010010010001000000000001000000001000000
01001110010010100110000001000000010011010100000000000000011111100010010101000001000001110101101010010
00010100001000000010001001111000000010110100101000100001100000100001011010001000000010000000101101000
00000000101000110100011000100000100001000000000110001111110100110000000000100010010000000110000100000
00000001101010011100100011000000000001111000100011010000000010010100101000001000010111010100000010000
01001001011100000100010000111010110000010000000100000100000001000100000101001110001100000011000000100
01000010010010000011010000000100010111101000100001100001001100000111000110000001000000100100100101000
00010000011010101011000101000100000000010011000001100001000010000011010000011000000000110111000000110
01000000000000100011100010000000001100000010101000110000001010000000001000110110000001101100000100110
00001000010000000010101001000001110001100000010100100111000000000000001100010100001101001000001000010
00000000000001100101111000100001100000110000001000100101000000000000000000101000000001101010000110001
00000010010100100000000000010000000000010101000000010100000000100100000001000100011010001101000000001
01000101000000000001000000010010111011000000100100101100101010100010110100000111000000100110100111001
00010101000100100101010000100101100010000000010001000000001100010100011010010100011001000101100100000
10000000000110100010100000000000001101000001000010010000100000100001100000100011000000000000000011100
00000000010001000010000001110000011100100000011100010100000000110000100000000010101010000001010001000
00100100011000000000000000010000000101100000000011111001101000001010000000001111101000001001101000001
00110100001011100100011000110011011000001000011100000100000001100011010001100110100100000000001000110
00110100000000111010011111000100110010000000100001001011100000100001000100000000111000100100111001011
10010100011100011101010000101010001110000000000010001100001101000101001001000101101101110001000010000
00000000010100010000110101100010000000000000000001100011100000001001000000010100011110000000101100010
00000000000001010000010010011000000100000110100100011010000000100100000001011010110000000110010010001