82,72
86,25
10001010001000000010110110100000000101000000000001010001011001000000100000001100001001101000000000000
11010100100000100000011100100100011000110100000000010000101100110101110010101000101101000011100001000
00001000110100000001000000010111010010000100110000001011010010010101001101000110000001000000000011100
10000010100000010011000010000101100001001010000100001000100000111010001010010110000011000000101001010
01100000000001100000101001010001100000001101000001100001000000001100010000000100100100101001010101000
00000010110101100100100100000001000000001100101110000100001100001000000010000001010000000000010000001
11000000100101010000000010100010110010000000101110010010100000011000000000011000100000110001101100001
00100000000001001001100001101000001100011000101011001110001000001000101110010010000010011010000010011
00010000100000000111001101001000001000000000100000010010000000000011100001110001001010000000000000101
00000000001000000001100000010000101111010011011110000101010111001010000010001000111001011000011100011
00110100010000010001000110000000100111001110001000011100110001010011000100100111010001100001101110011
01110000001011100000001000000000110000100010100000110101110010100001000001100000100010011100001100001
00101100010101111000110000000000000010000000101000010100100000000100001001100000001010100000010001000
01110110000100000111100000000100011000000100000100111000000010000000010000100000001101110101101001000
11000100101000011000000010011100000001001001000001001000001000110110101010110011000100010100100000100
11000011000111010101101100010010010000101010010001001100000000100101000000001100000001001001100100100
00000000110110110010100000110000000000110000000000100100010011111110000110100010100001000100010000100
01010000000000000000100010101000000110000000000101101010000010110001000010101010000001010000011001011
00000000101000000001000100100001000000000101000000000000000000010100011000010010011011101010000000010
11000111001010001000010100011000001000011000100100100000000001100010010000000010001001000000000100100
10110100100110100001010000001011000111010000011000000010010011100110011001000011000000000000001110100
10011001010110010000000010000011000110010111110010100011100111001000110001010001010100001001000001000
00001010100000001101000001001000000000100100010001010010111000110000001000010010100100000010100001100
10000000100101000000000100000000000010010000000101000010000100000100100010100001000111010011110100100
10000000010010010000100000000100100001001000010000000001100100011001100101110000010001000101110001010
10000011001000001001011110000010001001100011110000000000001100010000000100000000000000100000000001000
00000000000001001100100010100101000010001011100001000001001101111110101000101010011000000110000001110
00011110010010110000100000001100000010001010010100100001110000000110010010111000100111000000101000000
11000000110010011011000100100010001010100010110100000110000010111000000000000000001010110000010001000
01000100000001101000000011000101001100110000000001010000001011011100000100001010100101011100000000011
00010000011011000100000001001001001100011001000010001000010000110000100000000010000000011110111111100
01100000111101010010101010010100110010001111001010010000010101010000001010101000011001111011000100100
00100010110001000000000000000000010001000000000000011000011000000010001100011000001001101000111100000
10010100101010110010101001010000001111011000100001100001101011100000000001000001100001001000101000100
10000000000010000010000001100010000000100000001110010011010011000101100101000001001001100010000011100
00000100010010000101000001011000010111011101000000001000000111010100001001101110001110010000010000001
00101001000000010101001000100000100000111010001000000000110000010001110001010011011000000110011010110
11000001000010011001000010001000010000010010000100111010010010100000000000000111101001010000100000010
00011100000011110110000100001110000011100000010100000010111110100100000000000000101001100001000000001
01000000000110010010000100010010001100000000100001001010010000000000000000010000000001101000000110011
10010001100000100100001000000111110000000001100110000000101010110111010000001110001011000001111100010
00000010000101000010000000000100010000010000010100001010001000010001001011110110000000011000000110100
01000100000111010111000011101000000100011001001000010000010000010010101010001000100000010010000101001
10000010010001000001110100010000100000011000010000000100000010100000101000100011000011101001100000010
00001000001010000100000000000100010100001111010000000000100001100101001000000001000010000000100001000
11000000100010000100000000010100000011011000100000000011001101001000110001011100000100010000000000010
01111000001000100010100001000011000101100101001010000000000000101001000000001000001101010000010101000
01000100100100101010001010011010000001000000110100010100001010100000000000000100010100110000010000100
01011111001110010001010001010000101000001001110011010000000111000001000000000000101001000000100010010
10000000000000100000010000000000000010100100000001000010000010000000111010100100010000000000101010001
01001000100001000010000000110000000100000000001001100100001100001000000100100000100100000001001011000
10000001110101000011000100010101100001000010010000000001100010000000110100100111110000010000000000000
00010010010000100000010101010000100101010000000001111010000001000000001000101010010111001001100110000
11000001101010110000000011000010001000100000010001000010110100110010110010010000001000001010010110101
00001011011000011001000100100100010100000000001100011001000001100111000001000000010011000100110010000
10000011000000001100101010011011110110000000000100101101000100000010000000010001000000010101001000100
00001111010010000000101000110000001101000011110111010100001001000111001001100011011100110101100010010
00011001001000001000000000001000001000110000000100010010001000010001001000100110000111000100110000101
10100011000000000000101110101000100010010000111000100001000000010000101010000001000010001101100111000
01010100000010110000100100010100100100000010100000000000011001110110100000000000101001000010001110100
00100000000001101001110001011000101000000100000000011010000000000010000000000001000000011100100110001
01000101000100011011100010010000110000110000000100101010100001100001010011001010000110000001001100001
01110000000100010000000001010111001000100100000100001000110000000000000000001001101000100100010000000
11000010100000100010011011000100000000000010100100100000011101110001000000110000000010000000000010000
10010001010110001010001101011101110010000100110100000000000000000100000001101001100001000000001111001
00000010000101101000100000110000010101100110010001001010000000010010100010000000001001000010000110000
11000110100110110000000011010001110100001101000000000001010011000000001100001001100000000001100100001
10001100110010100000000000100001010110010100001010010000000010100001011000010000000001101000000100010
00001000011010110000010100010000001001101011100001011000000010000101010000010010010100000010010001000
01011010000010010000000010011101101000000000111100000010001100100000000100000001100001000101001010110
11000101000001110000100101000010000001010100101100000000100000001000100010100000101001110100000000100
00100111000000000100010101000010100000100011000000000101010000000001111000101100001100000001010011000
01100000011100110100001110000000010000011000000001100001000000100110000010010001100100010000100001001
00001001010000001110101100001000011100100011000001000100001000000001000110000010100100010100101100100
00010000000000001000100000000011100101000000010010001101011010000011110000000000100001000111010000101
00001001001000100000111000100100111000001000100000100000010010001001001001011010000100001100000010010
00010000001010000100010100011111000100000000000010011110001000110010000001001010101100000000000000100
00010000110001000100000001100000000100000000010001101100001000110001111000000001100101101001100000000
00010110000010100110001100001100010101010000000010101100000010010010000100000111000100000000110100000
01000000110101110001100110111000010001110000001010010000100010000100001000010001010010100100010000100
01001001100111001111110110000010000001000010011000111010001010000101000101000100001010000001000000000
01101110100101000101110001010000100000100000001000101000001000101010001000000001000000100010000000101
11001100010000000010100010000111110000001000101001000101010001000000011001001001000011100100010011011
00000110000000100100000011010000000100100000000101000010000000000011010100000000000000010100000000000
00000010100000010000100100101010100111000000010001011000000000010011000000000000100110000000001111100
01000100000000000101010000100100011000000000001011010010100000000010111000000100000110000000101111010
11000000110100111011101010000001000000001100000010001010001010111111110001010000010011010001000011010
10001000001100000101011000100101111101010001000000010001001010100000000000000100000101000001011000000
00010100100000010100100001000000000001000111001100000000100110100000001100000000010001000010010000101
10000000100001100000101100100000000100101100100001010001011000110001010011010000000101001100010000010
00000110100000100111000010001100000100001001001001011100100000001000001000000100011111100100011010100
00000000001010110100010010101011000010000010111101001100000011100111010101010000010000010001000100011
00010010010001110000000111011000010000000110010100000111001100000010110100000110011011000000100100011
00000000101010000100000000011000101001000001000000000110000000000001011000101100000101000010010110001
00000010001110100010000001010100000001011010000011010100000010001100001100000100001000110011000010100
01101010000000100001000000000100100000000111000000101000011011100010010100000110001000010000010011100
00000101010001000100010010101001000010110101000000100101010000001110000000011110000001000101010011010
00101101010011000000111001001010001010100100100000011111010100111001001000000111010001000000100000011
01100100000000100000100111001000100000000000000001110101000111100010001011110000010001100000100000111
10001010000010000001010000011111001011000000000000000110000100101100000000100000001010101001001000110
11010110000100001000010100000100000000000101001100000101000100101010011010101000010110010100100001000