26,15
25,44
10000000010001100000101010001001001111001000000000100100000000011000100010101000101000100000011010110
11011000000100000100010100000111001000101000001100010000000001010001001110000000100100000010111101011
11000011100001000100011110000111000111011000110000110100010001001000010000111100011100101000001100010
00000011100000001001000001000100101001100000001000100001100110011100000011110010000000100010000110010
00000000000010001101000000000000001000100110000001010010000100011001010000000000000110000000010011010
01000100011000000000010110000100001000011000001010110001101010010010000000001100010000000010010100100
10010100010001100010101101010110110010100001000010001110000001000001100000010110111111001010100000010
10010110100000000000011000100110000000111000001001100010001100100010000000010000000110111100000100110
10010110011010111000000100010001100011000111000000000000000110100101001100101101011001101000110000100
10010000000000110000100101001000100000001110000010001001000000100000000000000001010100010011010001010
01000110001100110000000000001100011000111000000100000101010000000000111001100000110010000011100000000
01000000110010011011101010100011000000101000001110000000000000001010001111010000001000000000000000001
10110100000000100001000011000010000000011000011001011000100000010001111001110011100000001010010011000
11011011110000010001010000110010010110010100100001000000000100000000000000001100110000101000000010011
00011001000000000110000001110010001001000000000100110001010010110100000110110110000011000010010000100
00000001001101110000100000000101010100000000111100011100001000001001010010000100000000011000100000010
01000000001000000100011000010110001100001001000001101110000010001101010000100001010111000110100010001
00111100100010001111001001000100000010011000001011010010001000001010110100100010100100000001000000001
10011000110010100000011000110011000000010000000011010001000100000000001110001010110001000000100011001
00101000000000010011001001101010100101100100001000100101001000000000000110001011000000000000100010100
11111000100001100001000010000101001000001101000000100011000001011100001001110000010011000010100100000
10000010000110010100000101100001110010100100110100100100001000100011100000000000000000001100111100000
00010101010100010000101011000110110010001000000101100010000000011100000000110101110010100000000100100
00000001000000110000000000001100011000010001000001001100110000001010001010000000000000001000000000100
10000000011101110010111000011100110011110000001001001001000111011000101010000010010000000000101001000
10100001000011000000100000100000000100111100000000001110000000000100010000110110101000000000001101010
00100000011000100011001000010010010011000010000000001011010100010001011000000100000011100000011100000
00110000000000100000101110101010100000000100000000100001010100001001000010010101010011010010000011010
00110110100000010011011010000001100000000000000100001100011000110000100000100000100000010101010000011
01110100100000111110101010001010010110000000010101110000010001101000011010000001101000000010001100110
00000010000001000001010001000000111000010001100100110001100001000000110000111010000101100000001011100
10001001111101000000000100001110001011000110100010000100001100000001000000100101010001000000100000010
11000100011001000000110111100000100000000000000011000101110010011000000000101000001000000100100010000
00000100001010000101110000010001010110010011010010100100000110100101001000101000000010000000111000010
00000000101111010100011001001010010000000100110000001000000001100010000100001000011000000001101100110
00000010100100100011000111000100000001000000010001000000100000010000101000011100000110000000001100000
00010000010001100011000000000001001000010000101000010000001010011101000000000110010010001101100100100
11000000000001100000010101010100000000110110000101011101000000000000000000010010011110001000101010011
00000111110110010100100001000100101101000000010001001100010000000000111100100000100001100100100010010
10100000000000100100000011100000010011001000001011100010000000001100010101001001100001010110010011011
00000000000000000000000000000011101011000110000100100110000100000001010000010000001100001000000000000
00101000001100010000000100000010000101000100110110100010000001001011010010010001100000010001000111000
01101000000111000010000000101100101101000000000010000000000001000110001000000010000010100000001010010
00000010001000010010001010011100000000000000010101110001110110001000000000000000011000000001011101010
01110010101011001111100001100000101000011100000000000000010001001001101100011000001000100101000000100
00000111101001011011000011100001100100000000000111110000011110110000110000000000100110000100100000101
00001000001001001000101010001110000001001000000000001001100101010010001100100100000001000101100010010
01100101001001011100010001110000000011100110000100010100000000010000110010100011110000000010100010101
00000001000000001000000000100100001011000000001101000011101000000001011010010000100101001010001000000
00110100101100101010111001010000000111000000000110101000100001100000100011010100100001000010000100011
10001100010001110101100000001001010000000000110001111101000000100000000011111010001000001001100000110
00001100010100100000100001011001010101100100110001010000100101100000100000011000000000011100000010011
01000001010100100000010010010000001000010100000010101100000000101000000100000100001001110100000010010
00000100111000001001011000000001001000000000100100000110000000001001110110010100000000001100010100001
00100100001100000101010000001000011001100100010010001001011100111000101001011001001101000000000101100
11000000000011011000001000001110111000010010110110100010010100110100010000100100000000000100100110000
00011001000010101001000111101000100000100000100000010001001000010100101010001000000010000001000100010
00010111011000100000000110010000011001000100000010000100100000000001000010000010110000110000000000000
00011000010001110010000010001000001000000010000000110001110010010000110100110000000001001001000101110
11100110001000010111100100111011110000100000101000010101010100111000010001000000100110000000010001100
00100100010010100000001100001100100100110101000100100010100111001000001110000010100000111011000111001
01000001000000010110010000001000010011000101100101000000100010100000011010100100001000100100010001011
01000001000110000001110000000100001100100000000100000100001010011010100100101010110101000000110000001
10000100010001010000100100100110000100000110111000000000000000000101010001110100010001110100100000010
11001100001010010011010000010010010000110000011100000001010000010100100000000001000100000001100000010
10000100000000000010000010001100100001000000011100001000000000000011000010000010011001000111000001000
01100100100110101010111000100000000001010001000100000010000000010001000000101010000100100001010110001
01011100010010100000010010010111000100001100001000010001001111001000000101010000001000011011100001000
00001000001000000000000010000101100000001001000010010100100011010010000011100010000001000000110110001
01010000100110000101110010000000100000001100000010001000000010000101000010100000000001011000000001010
00011000000100010000000000001000000101110010001000001001100000100010000010011001000000001111000110001
01101001110011000010010001000000000000010101110000000000100000001000100100010000110010011100001110001
00110010000011110100000110000000100000010101000010010000000001011010001001010110010001101001100100000
10000100001100000001000010001011001101001000011000000111000000010100001000001010010100000100000000100
01101000000001110011100100100000000110100000100000010000000001000011100000001010000000001011000110000
00000000001000100000010001010011101010000000011000100100000001000000010000000000101010101101011010100
00000011000100000000110001100000000010100110011100011100101111001101001100101000001001010101000001010
10101000000101000010010000001001100010000000011010000001000101000011000000000000010010000000001100010
00100000111000000100000000100000000011010000000100000001000101010000000001101100010000011000000100011
00010000000010100101011010010000101000000100011000000010001101001110001010111010000001110100000100111
00001000010000000001100001010001111010000000000100000100000000100101000000100100000000101101010001000
00001000001000000100100000100100110101000101000000000001000000110010001011000000001101000010110010101
10000010000100000110100010000000010001000001100100000000000100110000000010110010010011000010100000010
10110000001000101001010110010011110001100001000011000010100000100000000000001100001100000000010000101
00111000000100100100011010100101000101001100001001000001011110001101001000000010010000010100010111001
01001110000100001110110100000000100100110000011101001010000101000100000001001000010000110010100010110
01010100010000001000001010011101110010000000100100000010010000000101101001000001010110000010011001101
11000010000100100000000100000000110001110011101001011100010010100010000000000100101100010000010011010
01010100000001011000000000001000001110000000000011000000000000000000000001100001100111000000010000000
00111110001001010001111100001011100101110001100100001110011000001100000000010000000110101001001000000
00110000101111001001101000111010001110001001010000001100010100000100001000011000000110111100010010000
00010000101100100000000000001010000000000001101100100100111000000001010101010010011000001000001100100
01100100101110011010000100000100000010000000000000000110000000110010011100100011000111010110100110110
00101010010000010000100000110010000010000010010000010000101011001011010010010000001110100010011010010
10000000001010100011000010000100000000000010110110100100010010011000010001001100100110000100110101010
01000001111000110010101010000000000010000000001101010000001000001010000010110010010010010101101000000
00110001100000001000100000001001010100001010000011011101011111000011100110101000010110000000000001000
00000100000000111000110000000010100000000100010110001001100001010010010001010100010100011010000110100
10101100100000100000011010000100010010000110010000010000000000000111000000100000110010101010100100000
00000000100100001011000000100111000000110100000010001010001100001000001010000000100101010001010100100
00100110001001000000100111000100000101001001101110001000010101110100000010001001011011011010111100000