87,70
80,32
00100111100100000010000000001101001001000000010001000101000111101001000101001010000000000001100000100
01000100010011100000100000000100100010011000000001001110000000010110110010001100000010010010011001010
00011011000000010001001101001000010001011100010100011100100000010000000000000000000001010000100100000
00000010101110001110000000011000101101001100010000010010101000010101100000100100000101000001000001100
00100100000011000000100010001000000011010000100000100001010100000001100001000011000001101001010000100
00001000100100011101000000110010110000000000010000100100011010000011000111001100001001100010101010000
00001010110010000000000000010000001010011100001000011000000001101000010000010001000010001000010100101
00000001100100000001001100000111010011000000000010010100100011000010101000110000000011100000001000010
10001000010011000101010001101000001011100001000100101010000001010110010000000010000001100110001010110
11000000100000000000110001000000001000010100000100010000000000010110111000000000000010001111001101001
11000000010110000100001000000011100100010111001000000010011010000100001010000101101000100011000010110
00000110100101000110010001101111000010010000000001110000010000000000100000110001010100000100010001000
00000000111000000100011010110010110100010000011000000010000000000011000000100110010100101101010000000
00011000100110100000000110110111101111000000101000100000111000101000001010001000001001010000001101111
10011000010000001000100001011101001000010001001001000000110000010100011011001011001100010000000010010
00001001010100001001010101000001100001000010010010000101000010100010101010000100001001101010010000101
00010100010000001000111010010000001000100000000000100000010000000100000000101010001110000010001000000
00110000001100011000000000011000101100110100000010001010010011001000010010101010001011000000100000101
11011100010000000010101011100100010000101000001000000001101000100011010010001001001101000100100101010
10100010110000001001000111010111011000000000100000100101001000101100000010100110000001000001111000001
00000010100000001000000000000001000010101110110000000110000001000111010000001000010111101001110011000
00110000000011010001000001001010011011001010001010010010101000100100000010010000010000000010000000100
00001010100010011001000100000010001101000000101101001001000000101001000000000000001100110000100100100
00000111100110000110100111110000010000100010001100000000001000110001011010011000000000100000001011001
00001000110000110010101001000100001000000000100001100010101000100100100000000001000011100000001000110
00001100000011000001011000000001000111010001010000100100100100011000001000000011001000001001100010000
01000110100011110000001100000010000010100000001100101010101011001000000000100000101101000100000000000
00000101000000110010000000000100000010100010001000000111001101100010000111100001000000001001011001001
11100001100010110000100010000010001010000001100000001000100000100011000000001000001000000010000101000
00111000000100000110001000010000001000000000100100010000000001000101111011000010001010000010100001110
00111100100010110000000000000000000000100000010001010001000101011010101010000000001110001001110001001
01001000000000101000100010000000010010110110010110000010001100010000101010100000010000111000101000101
01001011100001010100101001100100100100000100101000000001010110000001000000000000100000000100010001000
00000000100100000000000100100100010000100010000110000000000000000000000010100010010010111000110001100
10001001100100000000010011001010110001110010010100000000001001001011100001000100100011100100010000010
00010000100101000000100100001000001100100110100010001000100010000100110010100000100100010000100011010
10010000010000010001000011001000001001000001010011100000000010010010000010000100010000000111100011000
00010001010010011010000100000110000000100011001010001110100000010010000101010100100001010001001100010
10001001001000000000111000000000000100001000011001100001010001110100001110000001001001100011000100110
01000000000000000100001100000000000001010010001010011010000000101101100001001000000000001100000011001
00010000010000100001010000000001000011001010000000000001100010011001001111010100100000010001011000001
10100000101000010000010010000011001100001001010011001000001111011000000100110111010101010101000001111
00000000000001101100000000000010000001000011000000010101001001010110000000000000011100000000110000011
00110000010010000000100010110110000011000110011110011001010010100011010000010000000001111100010001011
00110000100000111001000001101010100000011000010011100100000100001010001001100011000011101000011100101
01100000110110100001010010010000100001000001010001000010000100111101011000000100110000010000100001110
00111110110001100001011001010110000100000000110110000100100000011100100100100000100010010001000011100
10100101100100100010000010010011010001000000010110000000111000000101101000010000000001011010001010100
11101101000100110001000000000000001000011011100000001000000000000000010000000000110011011001000100001
01001000010010001100110101000010101000001110000110101001000110000000010000100010001000000000100101101
00000000010000000010000100110000000100000000010000011010000000100000000010000010000001010000001000001
01001100000000000101100000000100100000010001100000001110100100001110101001101101100110010001010001010
10000010100010010000000110101100011000100101000000001110001010100010010101000010010000010000010001001
01000001000100101010010011101001001001000101000000011100010000010001010100000011100000000000001000000
10010000000010100010000000100001000101000000000001101000000101000100010000010011001001001000110010000
00000100010000100000001000001000100111100000101010110001011000000000010000011100000001100000111001000
10101100001000011010001110000110000001001100100111100001100000000010000000001100000110010000010000111
01000110100010001001110000000110110101000000000110001110001000000100000010000000100010100101100100011
00001100000000000001000000110000000000101111001000000010010010000000000010000001001010101000000100000
00010011011001010010010110000010000000100000000000100001010111110000111000110100100001001010100001000
00010000000000010000001011100001000000101000100010011000010100000010011000100100011001101100000000011
11010100000101011000100010000000100001000000100100000000101001000000000000000101000000000111000010000
00010110010100101000000010010011010001000000000100000110010011010000110100110000000011100000001000000
00011000001001001011100010000000001011100000001000100000000100110001000100011100000100000100000010001
10010110111000000010001000101000000110000111010000100011011010100001001010101000000011010001010000001
00000010000000000100001000110110000000110000100011010010111011000100000000000000000100100110010001100
00001111010000010001100001000001100000100000000000111011011011000100101101000011101001000100000000000
01001001000010000100001010010001000100010001011101110000001101000111100011010000001101001010100000001
00001000000000111001100000001011111100001010000001010110001000010010000001000000001000010001110000010
10000100011011000010011000000100001000100100101000100001110010010010110101100000010000001000011000000
00010110000000010000110000000011100011110001100101000000000000010000010001001111010000000011100100000
00010110011100001010000000100001000010101001100000101100100110001100001100001001001010000010000110000
00000010011001101000110000110010000000001010000000001000011000001000100000000001000000000000000010110
00000001001010101000111011010100101000100110001010000110010001000000010010001000110010000110111000100
00000011001001000010000001000100000100000100010001000000100000010001010000101000100110111000010001100
10101100000111100010100000111010000010000010100100100001000010110010101010001001011000010000101000001
00000000000000001100001110010110010100000100010100001000000001000111000000111110110110000000001110000
00000011011100001110011101110000001101000011000000000000100001100111001000100001000100000011010000000
00011001000101100001010010100011000001001001000000001001000100100001000000000100100011011000000010011
01001000101010000001010000001000000000000001110101000001100000000001100100010000000000101000100001100
00000000000100100000101011000001001000000110000000001001000001010010001011000010101000101101010010001
00001011000000000010001000000110010000010000100000011001001010100000001110101000010110000000101000101
11000100000000001100000110000110010010011001000100000010001000010101010101000010101101011000010000010
00000001000001000001000010010011111001100000010101011000010001000000000000100001000001000000000001100
00100001011000000001000000000011101110101110101001011010111001001000010001110101110010001100000100010
00001010100000100000000100000001000010111100100000000000100000000110000010100000011100000110001100100
01000001110100000010001000101011110100110100001010111001010100000010010000110010001000110000000100001
10000000000110100110100010000101011000000100000010001000101110010000100001011000010000000111001000000
01010000000000000001111000100010000000110010101010100010000111101000010000000010101001010010101000110
00010001100100100101100010011001110101000010111000010001110000111011010010101101000001010100011100011
10101000100001000001100010100001001101010010000001001100000100000001000000001001000001011000000001000
01000000110100010001000001100001100101000001100100000011001011100000001001000110000010000010010010000
01100000010000010010100110001011000000001000000001000110000001001001010001011101111010101100100000001
10110101001110001010000010011010010010111000001000000000100011100000010001000111010110001110000101000
11001010100010000011000000000000100110000010101010010000011001001010010101000010110010010000000000000
00100000011000010000011100111001111000000100001000111100000000001000010000000000100111110000010000000
10010000010010000000000001101100000110100101001000000011000100000000010010001000000011000000000011001
00010000100101000000001010001100010000000000000110110000010101000010000100000010000100000000000010000
10001000000000101001101101101110100011001101001000000100001001000000000001010000100000010001000000100
11010000010010100000100110000011000100000010100111100100110010000001110101000000000000100100010001000
10000000000100000001110110011100000000010000101001010100000101000001000100000001100010000100000010000