23,35
2,1
00001000100001110101001000000101000010100000011000001100100000001000110001100000011001110011010000010
01010100101010000110000111010000011000110110000000101010001000000000000001000000001000000010000100001
01010010000111100010000110010001001000010100000010100100000000011011000010001010001000010000111100000
10000111101001000000101100000001000101000110100000110000000001010111000000000000000001010000011000101
00111001001000011001101000110100010000010000010110101000110100000000001000000101000000100100000000000
01010000010000000001010000000100000010010000011010101000001010000000000011100010100010000001100000000
00000010000001010000100000001010001101000000110000001000010111101000000000100000000001101010001110100
01010001000000000000001001001000000110110001011100000000100100010100100111000010101000100000011100000
00000001001101111011000000000001000001010000001100000011000100101000001000101010110001111001100000001
10100101000000100000001001110001000001010001001000010001110010100110100000101001010101000001100100100
11101000000000000011001100000000001001110010100000000101000000001010001000000100001100000010000010000
00011000110010001100000010010100010000000000001001001100000100000000001000001100001100100010001100010
00010101000000010001000000000010010000001011000010100000010100001000001010001110001100100100000000011
00100001101011101110011000110100001000010101001001100000001000001111101000100001001100000100000000001
10010000000001010001001000010101011000010001001000000011100000100100000101001010011010101011000010000
00000000011000001001010010000000000001010110010001000000000000001000000001011001000100011001010101011
00100000000101101110010100001101000000001010101010001101110100000000000000110000000001010001101001000
10000000001010100010100000100000000000010000001010000000000000000100000000000001011011010000011100101
11100011000000001000000001110100000011111110011010000100100001000100010001111000000100101010111010000
00110000010000000001011000000000101100110010010001000000010010100111101000000000001000001101010111001
11000000011100000110001100000000000100000001011000000001001100000001010000110000101001000001000001001
10000001010000000100001100100001001101010101010000001001000000010100101000000001100000101010001000110
00000110001001001000110010100010000000100000000100011000000001000101010000001000000010110001000101011
01100001100111011000010000010001100000001000101100001000001010001000000010000000110010100100100100001
01000001010111011000111011000100100000011000000010000000101101100000100100000000100000101000000000010
01000101110010001001001000110000010000000000000001001100010000011011000010000011010010010010000010000
00000000010000001000010101000011000000100010010000001001000100000011001011000100001101110000011100100
10001101000011010010101010100100000100000100000010001001000000010000001110100001100000100100001100001
00010000000001001000010100000011101010100000001000010001000000000000000000000011000100000010010101001
00000100000000000010011001000001100001000101100110000000011010100000010011100000000110010000100011011
00010000111010000001000101011000001001010001110000000000100000100001000110101000110000111100010000000
00010000000000000001000000000110110000000001000100001100100100100101011000101001010000000011010000001
11100001000101110011000001000001100000100110001101100001010000000000001000101000000010000101010101000
00100011010010110100010000001001001101000000100010001000100000101010001110010000001100000000000000000
00000001000000011000000001000000010101010001010000100000000010110000100100100000110000000000000101001
00000100001001000000111110101000100000010000000101001000100001000011011000000010000010100011010000100
11010011000001001000000000000010010000000000100111010001001000011011001000001000000100011000011010000
10000000000001000001110000001010110110101001101001011110011000010010010010110000000101011001000001000
00001000010000001000000101011001101001001101000100101001010100000011001101001110010001111100001010000
00010110110100000001001000000001000000001010000000010100100101100100000101100101000000000010001001000
00100000100000000100101010110100000000111000010010000000000101110100000000011000100000000000101010101
00000001000000000100010001000010010000000000001010000001101110100011001010100011010000000101000000000
10100100000011100001000001000010010001110011010000100000000001001101001111000100001100101001000000000
10110000001101110101110010000111000000010010110000100001110000100110010011000000000001000000011011011
01011100000001000011010100000001010110100110100000000011011010001000010101000100001000000000000001011
00100001010001000000010110001000001000100100001010001000000000110100100000010100000000011000000001000
11001110011100000000010001001000000101000000110001110011000010101101111000001010000010110100000001001
01000000000001000000100100001000100000000110000101110100000001010100010001010000000001100001010000000
00000000010000110010001100000110110110010000001100000110010011001000010000110000110000000110011001000
11010101001100101000010000110100010001000001011001100000000110000010011000000001010100101100101000100
10110010000000110000111110010001100101011000000100100010010010000010100010000110111000100010011110010
01011010101001110010001010001000100000100001110001000000101000001001000001000000010000101111001110001
00001000010000000010001011010101100000001001010000001011001000010001000100110000001100000000110001110
00000000101000100110100011010011100111000110010000001001010000001100101110101100010111000010100000011
00110001000110100100000010000011001000110100011000100100000100110110010000100000011000100000000011000
01001010001000000000000101100000001110011001000011010100000001000101100101010100000110001110100000100
01000100000001010001000000110001110110001100000010000000001110111000000000000010101000011011000000011
01000001010000000000010000001110010101101001011100000000010001001000000101000110000110001100010101000
01000000010100011101000110000101000000011100010000010000101100010010010010111100100000010001010101010
01000001000101000000011000001000011000000010010010000010001011011000111001010100001000001010001000101
00001000101000000000100100000000100100010100011100001001100000001110010001011010100000000000110100000
11000000000110100100001000010000000100010010100000010000000010110010001000000110110100000001000110011
00100000110101001100010011001011101100000010011011000000000010100100000010000010000110000010001101110
01000010011101100100010000001100000010001101010101001111000101001010000000100001010001000000000000000
00000110000000100100000000000000000100001011100010001001100000110001100111011000011101000100010001000
00001001000110111111000100000010001100100010001010000000001000010010111010000010001100100111100000001
10001000000001100000001001000100000000000100001011010010000100101101100111010100110000000100010000010
00110001001000110001001000010101101111011010100011000000000011110000000101001000000010000110000000100
01011000011000010101010011001011000011000010000010001100100000010100000101001000000101001000001001101
00011001000101000100100010100000100100000110100000001100000100000101100000001010000000000001101010001
00100000000000011001100000001000010000000011010000101000011000000000110000000101010010010001011101100
11000001010100000000010100101000110010101010111101010101001000001000010010010000011010011100010100000
10000000110101011011010010010000000000000011001000010000000010100010000110101101000100000000000001100
10000111000110010000000000010010000101000111010001001110100001001001000100100000100001010001010010101
01000100000010000010110000100000111100101110101101011001000000001000010000010010000100000001000110000
00000011110100000000000101010100010000000000000001000001000000000100000010000100010010000000111000011
10010011111010000001000000001000100010000110011101011000110101000010010001000000100010001000000100001
00010100001000010010000110000001000000000000001010000100010010000100000010001001001001010101000001000
00000101000101001000110010001011001000000100001000001100011101101000001011010010010010000010000110000
00100011001110000000101000000100000001011001100000010000000000000001011010001011001010111000100011010
00110101000000101010101000010000101010001010110100010001011100110000000000110000000010000000100010010
00000000010000100110010110000010100000111110000000010001000100001001011100011000001101001000010100000
10001101000010010000010000100110110100110001000011011010000001001000011000101011000000011111000000100
10000001000000000000000001000000111010100000010100000000011010001001000000100100001011000000000100111
01011110001000011000000001000101001011001010000111111010001000100100000100000110000101101000110100110
00011000001100000000100000010000101010001100100000010010110010100010001000001000100000000000010100000
11011000001000011100000000001011100000000001100110000000010000111000000110010000101100001000010011100
01000000000110001100000100001000000010010100000100011100100100001110010000000000110000000010000001101
10000000000000001110101111000001011110111001111000000110000001011000001100010000101000100100110100001
10000000000001100000001011000010000011010001010101000001000010010010100000101000011010011000001100100
10010000011100000110111010010111010101000000100000000010000110000010101001011011000000100001010001001
10100000010011010000001011000100100001011100010010000100100001011000100000010010010101001000000000000
00010001010000000100110010001100000000101110100000010000000000010000011000100001100100000011101010100
00000011000000100001011100101100110000010010000000000001000000101001010100111000000101110001011001100
00010010110011000000111001001001011000101100000110111010101010101001111011000110010101101010000100100
10000000000000000000000101001110010001100100000000100101000000000000101101110000110000000000010101000
00001010000001011100001000000001100010100111100001001000110000010011100100001000000010010110100000000
10000001000010000000000010011000001010001110000011000000000010000000010000011000111001100001100010011
00101100101000010000110000000001000101110000000000001001100100000000100110000010000101001000100111000
00010000010110000110100000000011010100011000000001011000001000100001001000000001000001001100110000101
00000000000001000001100000010110111000001000010101001001110001000100100000001011111101001000101100011