23,80
55,31
00000000000000100000000001000100100001000100001000101101000110001000111001000001000011000010101110001
00000100101001011110000001000100100000000100000000000000001000000001000010000001000100000000100100100
10001000000010110001100100000000000000000100010000001110011011101000110001010001101001111010011000100
00110101011000010000000101100100000011000101001011100110100011000001101110000110001010001100110010100
00000101011001000000100001100000010001000101011000011100000010000000110000000000000111010100001000011
11101000000011000101100100001000011101000100001110000000000110000011000001100100000011100000110110000
00000000000001100000010010000010100000110110000001000101100001000101100001100100000000010010000100011
00100000100000000110000000001001010001000101010010000000100000000101010010001000000000110001010010000
00001000100000100101000001010010000011001100010101010000100010001010000010100000110011110000001110110
10100010100001011010011101000110011100000000100000010100001100010001001000010000100110000101000001100
00100100000001001001011100000010000000000010000111001000100010000100010010110100001100101010000100000
00100000001100110011000010011010110000000011110010000000100011010100001000010000001011100010010001011
00000110011100010010010000100001011100000010000000001000000011101101000000000000001011010010010000000
10101000100101010100010000000001001000000000001010011100110100111110100100110010100000001000001011010
01110100100000000001111010110010010101000100010000000101010001001000000000100001001111100010000011010
01010000000100001110110000010001000010000101000010111000001000110000110001010010010110011100000000011
00100000101010101000100010001001001000000010000010010101010000000100000010000000110010000000010010000
00000001000100001000001000000001001001000001001000011001010000010000001000111000100000010111000110001
10100111111010000110010000011010001110001100010001011011110001100100001010000100000010000001000100011
01001001101001010010001011111000110011001000010001100000010000000101000000000000000010101010001001000
00100000010101000000010100000000000010000000000000001010000001010100010000000100000001010000000010000
00110110001100000110000101110001000010100000000110111111010000010011010001000100101100110011001001000
00001001000101111000010100010001000100010110000010000000010000100001000000101000110000000101000000100
01110010011001000000110010010000111100000000010000010111000001011000100011000000000100100100000110000
10100110000101010000100000100000100100001101000011000001100001110000000000100000001000100001010010010
01011110000000000101010000000100100000000000101100010000000000100110001001010100001010000000101001000
00110100100000010000110101110000001010110010010011000100110000010101100000000110000000010010000011000
00010010000010000100001000001000010010110000110000001011000000000100000000001000110010110000110100000
01100001001101000100011100000100000110100000000000100001000100010000001100100000011010000000000001000
00000101000011000101111000101100000100001000100100000010001000000001000010000001001000000001000000000
00000011001001000011000101101000100001100000001000000001111011000011000000001000001000100011000100101
00010000010000010001100010010001000001001100100111000000000110100011100011011011000011010010000000000
00001000110111000000100011001000000011100000001100000000000100000010000001100010010000010100100000000
11000101111100000000100001101100000110000000000100001000100010000100111110000000111001100110000011100
00000111000010110010100000000000001000000101001010000001101010101010011001000101011000000100001000101
01001011010010010010100100100000000011000001101000110110000101100000100001000011000000101000000010010
01001000000010100010011010000010000001100000001111100000000000000010110001000011000110000101000000110
00000001000011001001010010000101000001100010010000101100110101101000001101010101000000010000110100100
01000000001100000011101100110001000010000110000001011001001000011010010000000001000000010000000100011
00000101100000010001110100001000100000000010011000000100001010010100100110010110001000000000010010000
00000000000010000111000001110101001011000000000000010000110110101011111011101100010101110011110110000
00011011111000101101000000100001001100000010001000100011110110000000110111010010100001111100000001100
00101011001101001000110010001000000100100000110110010000000111010001000110100111101000010000000011000
11010001001001010011010101000100100011010010110000111011010100000000000000101100100011000000100100100
01001000000100000000000000001011000000100011001101001000100110011100100100010100000000000010010000010
10110100000001010100000001011100100010000011001110100100100000101000100100000101101000001000000000000
00101100000010000001011000100000100011000100000110000000000000001000001010010000000001000110011000011
00000010011000000010000000010110100101010100011010000011000001110011000011000000000100010000000001010
01011010010000000000000000001010010000100101000001000010000010011010010001101110100000100010000000100
00000001000110011010101101111101000110001110100100000000000001000011000000010100000011001110010010001
01100010110010010001000000011100001110100000010110000100110110011001010100000110100001000100100001100
00001001100010000100000010001000000100100011011100110010001000110000101000100010010001000011100110000
10100100000011011000001000010000100001111000000000011000001110011011000010000000010000000010101001101
10100000010000100101000000000000000000001101011001000000000000000001000011001010010000000000011000100
10011001000100000000011100000001001001000011101100100100100001000000010100000110100011000001111001001
00000100000010100101000000000000100000010010110010000100011000000001000011000000000011010110010000010
10000101011000001010010100001110110000000000000000001001010010010010000100111000000110011101100001001
10110101111101011000000101000000000111110110001110000001100101011010010000111110010000000000100100001
00000001001000000000001000000011010100010100000010000100000100110010100100111101011101101000000000010
10100100100001100010100001000000001000010110011001010001001000000000111000100000010001100000000000111
11000001011100000000111100000011100000011001000100110100000110110001100001001100010001100000000000101
01010011010000000100110010110001000010010000001001000000001011110000010001000110000000100010011000000
01110000101010000010010010110000110001001100001001100000000100100000000010100001000001011001101100000
10000000001011000100000101001000000100100000100100101100001100100000000010001100010100110000010101100
01000001001000100010011101011000010011000000101100001000001100100000101100001010010000000000100000100
01100000010000001000000001001100111111001010100111010000000100000010000001011100000011010000011000011
00001000010110101011000000000011100000011010000001000101101101001010010010001000100101110100100001000
11100000001000001011101000000001000000010000001010010000000000010000100001000100001100101011000101101
11001001100000001000010100001010000000001001001000110001000100110010000010000000010100000000011000100
10110010100000100100000010000100000010000000000101000000110001000010000000000010100100111001100000010
00000000000001101000100100010010100010100000000000001001100000010111000001010110000000000000010001000
00110000010000010111010001001010111001000100000001100010100000100011010000000111000101000000010101010
11001000000000101010010010110010100001100001101010100110101000101000010000110000101001000110000000100
10000101100001010010101100100000000100100101000001111010100010011000001010001010011000010110000000001
10000010001100010000010010011000000000010000010110110010010000000001000000000000100000000000100000110
00001001101001010000100110000010101001110000101110010001000101000100110010111110010010000001000000000
00101000010000000000011001010101000010000010000000000000100111000100010000100000010000010001010001010
00000000110000100000100011000001010000000000110010011000001010100000001100110000101010100010100100100
00001001000000000000000100110100110000000011001100000000100100000000000001000110000100100000011100000
10010101000001000011011010000000000000010101000111111010110100000000000001000001001101010100011000001
01000100011100101010000010100100000000101000100000010000010010001011011010100000100111010000000000100
10010110011111001001100011011110001101010100110010010010001000001100100010001000110000110010000000001
11001101000000010000000010001011110010101010001000001101101000100010101010100101000010110000000110100
00000010001000010110010000011100000000000000010001000101010000001110010101101000100010000010010010100
00001000100101101010010001100010100010110100001101100011000101000011000100000100000000011100000000000
00010000000001010000100100000111111010110100100010010011000100100011000101100000000100001011000101000
00000000010111000011100010000001000000000100001000000100011000000011001110000100110010000000001110000
00111000000000111100101001000110010000100000010010010111100000001100000011100000000000000000101000000
00100100010110000000000001000010000000000001010001000101110111101111111000101100001101000000010000001
00000010011010001101000010001000100000001000000001101100101000110110000100001100001100101100100000001
00010001001100010000011001000001010001100001010000010011100000000001000001011010000001010011110010100
00000011000001100000101011011000000000010000000000010001001011000100100100000010100000001001011100100
10110010110000000010110000001010001000100100100000000000001011100001100110001001001110000000111100100
11000000000011000000001010000001101000110100010000000101010110000000011010001000100000000010001011001
10001101000011110000100010010011000000010010111101000100000000000011000010000110100000000001100000100
10100000001010001010000001000010010010000000000000001010100001001010110011000010100000001001000111100
00100000100001010011011001110000010101000110000010001000010011111010001001000100000001001100000000001
00111010000110011000001111100101010000011001101001101000001011000101110000000001001001000111001010010
00000101100010101000001010011000000000000011100110000001000000000000001001000001000000100000101110101
01101011101000001000101000000100010000000100100000010010001010001001111000100001110111000100000000010
01110001101011000000111011001000000110000000001000010100000001000000000001100000001010000000011100000