51,34
56,99
01000001001110011000000001000000110010010000110100010010010001010000100110100001100001110110001001001
00000001111101100001010000011001000000111010000010001001001001100101000000100001001000000000010110000
00000000001000000001000110010101001001000000010101010001100110010000110100100001000101001010000010000
10011010000010001101001000000110101110000000000100001010000101000010000000110000001010000000000000001
10000001000011100011111000100001000010000000001000000100000111010100000010000010101000000010010100000
00101100001010100010000000001111000001111010000000000000000111100010100010110100101001011110100001100
00001001101000101010000000001110000010100000010011010000001110000101000010001011000000110101011101011
00100000110100001010010100000100000011001101001110000100101000000110100000001000010010010001101100100
00011010101000100101101000010001011100100000001011001111011010101110010010010000110110011001001001001
10111001010011010000001010000000001000100010001100110001011100010100000010100010000011100011110100000
00010011000001000010100000001100000111010010001000001000000000000110000001000000000000000001010111100
01010100000000110100001000010100000100110001110011000000000000000110100100000010001000010110000100110
01010001011001001010000000000010001000001010000001000110000100101001000110100001100101001000101011010
10011100010010000101011000101010001000011000101000110000010100000000010001010101111000000001100000000
10100000000101000000100001100010010010010010110100000000111000111001110000100000000010010111101110000
01110000110001001001100001110100000100100000000001100101000110000000000000000000010010000100011010010
11000100000000010001000000000000000010001111100101001001000000111000111000010000100010010010001000001
01000110001000010100110001010000001111000000000000001001100000010010000010110101111010000100000011100
10100001001101000101000000011000100000101011110001100000000001010011001101000001100111000000000011100
10110000110100011111100000010010010001000000000000011000101001000000000001000010100011010100000110000
00100010000010000010000000001001000110100000000010110001001000101010000010010011100001100100000100100
10000000000000000100100000000010011000010110100011000001011010101010001101110000011101000100101010010
00100100000001010000011010001011000100000001001110110001000010000001011010011000110100000000011000001
00100110110000001110110000000010011000010000000000100110100000001001100000001001000000110000010011110
00001100000000001010000010100100100001010100010001000100010000110100000001000000001011001000110010000
00101000000000000000101100000110001001000100000000010011000010101010100000100000001100000000001100110
01000101100000000010000100010000110011001011000000001000011011000000010010000000100110000001000010011
00000101100001011000001010000011111100101000110001000000000100000000001010100100111010011001010110010
00000110100000000001010100000111001100100000000100010000001000100010010000010111111000100001000100001
00010000010100001000111110000111110010011010110000000101000001011100000000000011010110011000001110010
10001011100000001000000000000010001010001101000010100010100001011000110000100100100100011010000100000
10101100010001001000000110100011001111000000000001010010000101100001000010001000100101100000001100000
11000000100010000010001000010000100001000000101000000000000100100010100001000001100100110101000101000
00011110011110111100100011000001000111000001000000010000001100000110101010110100000000000000010000100
01011011000100001000011000000110000010100000001100011000100001001110100001100000000111010000000101000
00011100100001000010000110000011000110000001000010000010010000000110101001000101001100100100111100001
00100000001000000101100010111010001000010100100000101010000000001100001101010000100001000110101011000
00100001000011000001000010000000000010000000010001100110101001000110110100101110101000010101000110000
00100000101000010000000000100100010110010000000011001010101110010000000001100001000101000000100000010
01010000010010010110000000001000100100011000100100000011000110001100000000001000000101101001000011000
00001001000001000000001100010000100011001000010000001000011100000010100000000101000011001101000000010
10110001010000010010100110000100011101100000000100100001101010000001100100100000000000010010010001001
11000001100000100000010100010000111010010111000010100110100000100100100000100001000000001000000111000
00010100000001000000011010001110110100000100001001100101010001101101000001000010000010010001101010000
00100000110100000011000001010110000000000000100000000001011000000011010010100000010000101000000001010
11000000000000010000000000000101001101100110010000001010000011100110001000010010101010010010110100000
00010010001010000000010000011100100000001110000110000010100010111011100010001000100010010000001000100
00010000000100000011010000000001110010000000001100101001000000011000001001000010000000111100101000000
00000101000101100110010001111001010000010110010010001010011100000100001100001000000000000000101100000
00100000100000110111010001001111011000000101000000000000010000001010001100000100011100010000000000000
10010010100000000100010011110001010000100000100010000010000011000000000000010100010000000010010101000
01000010001001000000100000000010000000011000100100000010101000011101000010100000011001100000100100001
11101001000000001000010110111000000001001101001010000001000001110000000100100101100000010000000110001
01000000010100001010001011010001000001010000001111000100000011000001100000001111011100100100001001100
00011110001100100001000101010000000110111000000010001011001001011100101000000000011011000001010101010
01000011000000110101000000100110011101001110010000011010100000000100011000001000101000101000100010000
01101000010011100010010001000001001010000000010100010100010001000000010000000001100001100000000000100
01110110010111000000100001011000011010000001101101000010100000100000101111011010000011010000010000100
00000110000000000000100100010010000011011101011010000010001110001000010010011001010000100101101010010
11001100100001000110011001010000000101000100011011001000101100000110000001010100000000000000111010001
00100000011100000110100001010110001000001000001011011000100000100110001001000110100000001011001000010
10000000000000010101001010000000011010101000000000011100001001010000100011001000100100000000000011000
11000011001000000000000101100010001100001001000000000100010000000100011010000000100000000000000000000
00000101011110001000000100001100000010101100010001100010000001110101001001100010011001000000000011011
10100100010110000110011110000010000000011000100011010110000110110100000011000000001000010001000000010
10001010110000001000011000010010100101000010011010110000000001000001101100100001100001000111010000101
01000010010100110101101010011011000000000000101000100001100001010010000001000110001000000010010000110
10010000001100000100000010010000100000000101011010110101111110000000100000100101011100000000000000100
00000101000110000000101000110100010000010001100110000101001000000011111001000011000010110000011000011
00110100100001100000100010101010010000000100010100011100010000101000100000010010001100010000000000010
11000010010101100001000000000000100011100001010001000010110010011101110101010000011000110000000000001
10000010001100011000010000010010000111001011000000100000000000010111100000000101101011000100011010111
01001001100100000010010000000100100100000000100010110010001110010010001000000010011110101011000100010
01110000000010010010011100101000000010000100100010000111101000010000001000001001100100000000000110000
01010100010001000011111100010000010111000010000110100010111000010001000000111010000001000000011001110
10000001000011001010100100001000100011011010011000110110100100110000010100010001100000101000101100010
00000011010000010001000010001010000100000010001000001000001110000000010100100000100100000001011000100
00000000100000101010000001010010101000111000101101000001110000110011000100000011010000001100001001000
00011100100000100100010000000010000000100011100000000010010100110100010001000010101001010000011010001
01010110101110100000000000000110010000010000010011000011101001010100001000000011001101000001110110110
11010001000010000000000000100010001000000010110010001001001010100010010010100100010101000000000101001
00000000010011010000001101010110011010000010000100010010001000000000000110010100000010101111101100010
00000010000110001100100010000000100011001000111000000100000010000110000101010101000010000001010010001
00010000100000100001101100100000100111010111101100001000010001010111100000010001000010000011000100011
01010000011000000000000101000010001101010011001001001010011111100001010100010001110000100001000010000
11000010010000001000110001000000000011000100101100000000100000001101010000000000101000000001000000110
00011000000001010000101000000000100010111001011001000100000011000100000000001110100001001000000100000
11001000100010000000000010110000111100000011001001110000001000000100000100000100000011101100100000000
00000000100110010000100100000101101010011100001110001000100000000000101000000100000110110000010101001
01000000000001000000011000010100010011000011100010000110001100000101010010000110011100000100110010011
10000010111010010000000001101001000111100000010000100000111000100101101001000101010000100000101110000
00000000000010101010000000010111010111000110100000000001000001101011010010001000011000000100000101000
01100100101100000010100000001010100101000001010000110101000110000001001000010001010001111000000100101
01100000100011001011010010100000000000010011000001001110111101100001000010001010110100100101000100000
00011101101000000001010101001101011101000000101001001000111000001101000000111000100001000110010011000
00010010011001000000001010101110001000100001000100001000110000101000100001001000000000100010100000100
10100100000000000000001100101001100100010000010000100001001001011000001000001000001010000100000001010
00010100000000001001001100010010010010001001000100001100100100010001010000010011110000000000011000000
11100110001100000100010000001000101000100010001100100000001001000111000100001000000000101000001000100
10101010001000110001000000111000100110110111100100110000000010111100000001011000001100010000000001101
01010100010011010010011010010000110000100011111001000111010110100000001110000001011100000001001000010