8,94
45,6
10000110001010100010111010000010010001011000000000100000000111011100001011100010001000000000110001100
00000000000000100000111001100001110100000110000100010000000100001010001000101011000101001101110001100
11111011000000000000000100100010100001000100010000000011001110010000011000001000100100000111000100000
01101000100110010010000011001000000100000001000000010000001000110100010001000001000000001000100000100
00001010010000001000010100010101010001000001001100011010100110000000100000010111100000100101001000000
01100010000010011111011000001101011110000000001000000110110000001001000001000010000011011011101101100
00000010100110000000010000101000001100000010001101000000001001001101001000000000000010001100010101011
01000010101001110100011001011101010001000000001100100001000000001001000100010010100000001110011000011
00010100100010100000100000001001000000001110000000011000000100110000111000110100010000100000100100101
11100010100100100000000110011100000010000001101001110000000010001000000001000110110000100100100001011
00000001100000010000001100010000000000010001000000010100000100000000110000100100111101010000111100000
10100100010110100100100000000001001001100000000101001000101000101010101001100001000001100001101100000
01110000101000101000100000000000110000001010011100000011000011001000000000100110011101010100010011101
00000100100010110100001000001000100100111000000001100100011001110000000101100111010110000100000000010
10100100000110111110000100000100101100100101011000111010000100000001000010110001110010000100100100000
00001000000010100000100101010100001010000010000000111101101000100000011001100001010010000000001110011
00100101100100001010011110010010000000001100111010000001000111000110100000101100000000010010100110100
00100010010101000000000100010000100100001000000111000000000000000100011000010000111000100011000010010
11001101001010100101001000001001011011100001010000000011001000001011000100100001111000001000000001000
01010010000101100000010000100000100000001000010000001111000101010001100011100100000001001000100000010
00000100010010101010010100011111010001110000000011000010001000100000000100110000001000100000100010000
10100000000011001001010000010000100000000001100000000010000000000100100001001010000100011010011000100
00001100011000000000101000000000000000000100001000010000000001001101000111100111010001011100011000110
10010010011000000010100001001000000100000001000000101001110000110100011100010001100100111010000001010
11011000000000110000000000000000001011000110111000011101101000000001000101001001000101001101000100111
01101010000001000011000100010101111000100100000000110100100000010110101001000101000010110011000000000
01010100001011001100001001000000000000000000100110101100100000011000010001000000000000100111000010001
00010000000000110110000010000000000000000100000100000010011000110000101000010100000000001100100001010
11100001101000110000000000000010001010000000001000000110100000000001000100010100010000000010101100100
01000011011001000001000000001010000000011010000000000100100100001001000010100011001000010001000100001
10111001010000001010001101011000001000110000000010100101100000001000001000001110001111101000100100000
00100000110000000010010111101100010001000000010000101000010001000010001110101000000010001001100110000
11100000001000000101011010000011010010000000001001001100010010000000010001101001100000100001000110000
00010100101000010010000101011000000000110010001000100101100001000100100000000110010011111001000000000
10011111001010010010000010111000010000000100101000101010001110011000101011011110100011100000001100101
10000010100000000000010001111000000010000110010000011101110000100110100001000100001101100001000010000
00000011011000001100001000000110100100001100110001010110001000001000011000001000111000001101000100001
10000011001100010010101001010100010110000000001110001101010001010000001000000110001100100011101000000
11000111001100000010001010010100011000000010010000110010000101101000100000001111100101100001001011000
00101000000001001000110000001010100010000001001001100111101000000000100001110000010111001111010100100
01000101001001001100000000100010000000001000010001001110001010100000000000100000010000000001000110010
00000000000000001100010011010100010000100000011000000101101000000010000100101000000000000000101011000
00000001010000000000001000111000011000010001000000010001000001000000000000000010001001100011010000000
00000101010010000010000100011100001000011000000111010001000000000010101011000100000000100000001000010
11000000101011100000000001000110000010001000010111001010110001100010100100000100110001010010101000100
01000011000100010001011111001000001001001101000000010001001010000110001000000011101001000010000010100
10000010010000000000110011010100001000000000000101100001011000100000000100110001000110001000000010000
10010000000100010000000000101000000001000000100011000010110000000001101110100000000100000000001000001
00000010000100000000000010010001000100100000100110000000011000000000100000010100010001010110010101010
00101110011110100010001011000000010111100001100100100010000000001010001010011011000010100100000100000
01000000000000000001010001000101010001100101010101000000100000100010100000001101101100000111000101001
01010010010000000001010000011101011110000010001000010100110000001010000010000101110000011100000001000
00101100010110010001000000110001001111000000001000100000010010001000010100000100100011011000001100001
01010100000010000000001110000010000010100001010100011010010000010011011000010100010000101000101000000
00000000000110000100000010000001000101000101101100000111101000100100100000100001110001000001101000010
00001110000101000000001100111111101000100000001100100010100111100000001000000100100000110000000000000
00000010000100010000100100101000100000000001110000000000000010101010100000000000010100000010101000010
00000000000000000110000100000100001001110010011101000111000000001000001000000000000100110000000010001
00010000000011000000110000011100100011000000001010101000000000100000100001010000100101010010000100000
01100100000001011000100010000001001010000000000000001000010010000000000010010000010100001000100100001
00001100000010110100111100101001000111110000010000010010100000110000000110000101000000100010000010000
11000000100110111110000000010010010000101001111001000010010000110000101011110100000000100011001110000
00100001010010001001101101110100110000001011001101010000110100100000010000010000010000000010000011110
10000010010000000000100000001000001011000000000011101000000001001000001011000000000000001010000000000
00001011100000010000000001010011110101110000000110011000000100010101000000001001010010100000100000000
00111001110001110000000111100000001011000010001000000100111000001100000101000111000000101100000110110
00011010000100100000000011000100001100000100100110101001010010001000110110010001000001110000000000001
10000010000100100000000011101100010101001000101100000010010100001010011011001010010000101001010010000
10000001010000010010101000000101100111100101000011000000100001011000000010000101000101000000000000010
00111000100011001101000100000001001010000000000000000010011010011000011000100001000100001000111010000
01000001011000010001001100111101000000001110010110000101000001001001001100100000010000010011000011110
01111000001010010010011110001010100010000000001010000000010110000010000000001110101100011100000000011
11010000000000100000100101000101000000111100001011101011101000110101100010010100100000000000000000011
11100011000110000000110000100010000100000100010010100000000100010101011100010000000000010000000010100
10101011010011011100000110100000000010000100010000100011000011000010011110010001001100010000100010001
10011100110001110001100000010100110000000011000100000110000110100001011100010001001011000000111000000
00001000000100000000000111110010000011101100100110011000011101000000001101011000100001110001000010100
01000000000100000001010010000000010000000101000100110100000010000010011001001000100000101001000010100
00101000110000100000011001000000010101000010010100010001010100100001010111001000000100000101001001001
01111100001000110000001000100101110000000000010010001000000011100000000000001100101100100001110001101
00100010000000001000010000001010110101101011001000001000010000000011010110000000001100100110101001100
00100001001001000000100000001100000000100000100011000000000000010110001100010101010000101010100000100
00100001110100100000101010000010000000100100100000000100010101000001101000001010111111000001100000000
11101000100010011000000010011010001110101000100011000000010011110010111000001011000001000100001000110
00010100000010001010010000001000011100011000010001100110000000100011000101000010100000000000000000010
00000001000000010011010000101001100100000000000010110010110000000001101011001010011010000000000101100
01000000000100011001011000000000100000001011100100110010011011000000010010101010010100100011101000101
00000000010000001100000100000100000001000100001000010110000000100000100001100101000000000000101011010
10100111000001000111011010010000000000000001000010100011100100100001010101000010001000001110000100001
10000000000100011000000001001001010001000010000000110011001010101100000010100010001000010011001000001
10010001000000001000000100111010001110000001001000000001001000000010001001000000001000000110001000000
01000010100011000000010001101100100001111100000010110001001000101101010010000000000100110000000000010
01000000101100001001110001110100000000000010100000000000101010000001000100010000000000000101001100110
10001110000011010000100101010001100011001000100000000010111001110010100001001001001000001000001000100
01100000000010000000001110010001001010100010110000000000110011000000000110111000001110100000000000101
10101001010011010100010000000000010000110000100010000000101100101000000010000110010001111001000000000
00000010100100100110000100000010000000000101000000000010100100100100010001000000000011000000000001000
01010100000000100100000010101000011110010010001100100100001010001011010010000111100000000000100110001
10100000110000000000100000011000100001001001100010101000100010000001111010100000101001010001000000100
10010000000000000000100000100000001010010000000010101001000101111000111001010110000010000100000110000
01000010000001000000000001100010101000000011010100101100110010000111000100001001000100100100101010001