35,78
46,23
11010010000000000101011011000000000000010000000110101000001000000000100101000101100100111000010000000
10000100000100110011010001100101000001000110011001111000010001110100001110001001100000011010000000010
00111001000010011011011010010100000000100010010110000011100101001000001101000010010100000000110010000
10000000000000110101000100000000100000000001100010100101110110000000100010010100000001000010100000000
00010000010100000000000001010000100000000001011111000011000001000100000000101011000001100100001100001
00100001111101000000000000000111001100110101100000100000110101000010100000110000010000010000000000110
10001100001000000010001001100000101000001100001000111000010000010000100000001000010000000001101101001
10000001000001111000100000000000101011010010100001000010000001110001000001010000000010010000100010001
01000100001100000000000010101010000011000000001000000000000100000000100011000001000101001001110000001
01000000100110000110001011010000001001001101010000100000001001000110001000000100000010000001100010100
01110000001100000011001101100000010000010001000110000110000100000001101000010001000010001010001010010
00111001110011010010100001010100011001000000101000011001000101000101000001010110000000100010010000000
00101100001000100100000011010010100011000001101010000100000100001100010000110011000100000000000000010
10001000100100010000000010000110001010110000000011010110011001010110000100010000000111010000000000011
00000100000000000011010000100001100000000010100110000001010011000001000100100100001101000101000100100
11100011100001000010000000000000010011010000000001000000000100001101100000000101000110001000001110100
00010010110000101101000000000000001001010000011100010101101001000000001000110100110000001000000110001
00000001111001010010011000100100010000011010000010000000000010000111000000000011000000010010000100101
00010110001101100000001000100101000000001100100000000000110100100000000100100001000000000000001010000
10000010001000011001010010000001010000010010100111000100000001001010000001100001001100000111000010010
10000011000000000011000000000000101010000010010100100000011001100000101110000000011001000000000000001
00010110000011000000010011100100000000000001100000101000110011110110100000100010001000010011010011010
00000111010011000000010000011000010011100010001000000001101000011000000000101011000000011011100100000
10011110001001010010101110100010010001111000100001111001100000000000000000100000001101010001000000100
00000110010001000000000100000000000101100100100001001010010000101100100101000000101100100000010000100
00000000010100000010010110000000000111011111000100101001100110000101010000000000010011011001101000000
00010000110100100001100000000010101111000100001010111110101110100010000100000000101000010010000110101
10000001011000000100001010001101101000101000111010001001110000001000000000100000000000000010000100001
00010100000101010110000000001011001000011011010001011100000000001000001100001010000100010010000000101
10000100010110100010010001000001011100000011000000001100111000000001110000001000100100011000010000011
11000011100010011110000100000100000001001010011011000000100001110010001001010000100011000000000000011
00100001101011000001001000010000011010010000001100000000011000110100000010001101100010010001000000011
00000100000010000100011010100111010111000100000010011000010001010011001000000000000000100001000100000
00000000100100100100000000001100000100001000001001000101000100001100110000101000001000000001010100000
00110010100011001001011011010101010100001110100010001010000010100110110010000100000010010100100010010
01001000010001010001010000000001011010000010000001000000010011000000101010011100100101110110001101000
01101001101111011000000000100100000000001010010010100010011001000101000000001010000000000100110010010
00001101000100011001010001000001010001001111001001010011001000000101101000001100000001011010000011000
01110001001001100011101000000000000100010001010010100000111000001000011000000000011110000100000000010
00011000100100010000010010010010010000010001011010100000001100001011110100000010001100000100000001001
10000010000000010000001001000101001111010011101001100110100010001111001100110000000011000101010010000
10110110000001000010000011000001000000101001000000110000100001111000011101000000000000100101000000110
01011110001011010011001110000000001001001010100101000000100001100110001000100010101011010000011101110
00000001000000000001111110100000111010000010101001001000001000001001110011010010000000100000010010000
00010001001000001000000001010000000100011100001000001000001000001010001000001100000000110001100100000
11011110000001010001110000010000011000111010100000000000110000000001110100000010001110110001100000010
01001001000010000000100000000100101000010001000100110110010000000100001011001010010111110010001010000
00000110001111001010001111000100001000000011001100000000000001110101010010000001000010010100011010000
01000000011011000001000111000000101001001010101001000000100000000111100001000000101000000000000001010
01000000010110000000100100100010110000100000001010001000000010010110011000010000001000100000010001100
00000100100010000101000000100000000001000010100000011000010010001100000001000001010001010110100001001
00100111001010000000011001001100011000011101101000000001110100110000100000100000010110110001001111000
00010001010000000000100100001101000001001110000001000101110000000000010101011010010000010000000010001
00001001011000010110000000110000110011101101000101100000011001001010100000111001000011010101000011001
10011000000000000000101000001100100010111010000000001011010100000001001100000001101001000001000100000
00000110001000001000011101100101000101001101010010100000000101010101001011111000000000100111001000000
01011010110000000001000010000011100000000001001011000011000100000100100110100110001001010001010011000
00100110100001110000100011100100000010000000010111000010101000001100000000011001000100010110010010000
01000000101001100000000110100010100100011000010000001010000101011100011011000000001011100100100100001
01001000010000101000001001001000000000110100001001100000101010000100100100001000000001000101100101011
01110001010010000000100000000100010000000000101100010001001001101010001100001000000100000010000110000
10000000001001001000010000101001001000000000000001000001001001000111001111110100100000001010000100000
00100010000110010110011000100010000000000001000000100010110001000100001000001000000001100000000000000
10001010000000000100001000000000001000000000111000100011100010011000010000001010010100000000101000000
10000110000101001011001010000111010000100000100100000001010100101010100011000100101000010001000010010
00000100011100100011001110010010001100110100000000010010110100110000000000100010000001010010100100100
00000000010001100010100000100010000010100110000100110000010101000000000001100000011000000010100101110
10100000100100000001111010010010100001100100100000111001000010001100101011001000001000101001000000010
00001110000001011000011001000000110001000010000000001110001111000000111011011001100100000000010000000
00000000101010010001100000000011100000010000110000000100000000000000000011011010100000000000100010000
11001110000001000001110011010101100010000001011101000101010000001100010100000000100101110010110000001
10010100001010000011000100001001100100010101100000011100100110000101100111010010011000000100010010000
10100010110010100110010000000111101010100001100100011000111001001000010000000001000010000000100100110
01100000111010101000000010000100000110000000000001111010010100000000001100000010011000101010000110101
00000000100011100100000001000010000101110100000010110001110011000100000010101100011000100011101101011
00011101000000101100010101001000000011000000000000000000000001000011000010001000000100010000101000010
01001110110010000001100100000100001101000100000000000100010110000000100000000110010001110100001100000
00011000000000111000000000100101110101001110001010011000000010000000001011100001000111100100000001100
10000101000100000001000001000111011010000010001000000100110010110101000100000011101001100010010000001
00101000010111100000000001001001100100000000011110001000101110000011010010000100001010101000000010010
10000000000011100100011010000001001101001010000100001010010100110100000001000100110000001110111100100
00001110110001110000011000110001000100100010100000001000000000110000000010011000010010000000001000001
11100000100000000001011011010000010000011100001001101001000001010010010001000010101001001000001100101
00010100011001001100010110000110101110001000101000000110010010101000110000000000000110000000100000101
01010011100101000000010000001100010100100001110001010101000010000000000000100000000010010100100001100
10100000111001000000110000000010100010000000000100100011000100101010011000011100011000011000100001010
00001111100000100011000010000000011010010010000010100100000000000010100100010000000000100000000000010
10010010010000000001010000000010100100011001000000101000011010000000110000000000000000111001000110011
00000000000001100100100001000000100000000010100100000000000111010001000001111000010000101000000001000
00010100001011100000110010001110100001111010001000001101001000000000101001011111000001110100001000000
00001000100010100001000000100111011111000001100100001010000100101010000000010111100010010000000010000
10111010010000110001100101110100000000101011000010100000001100000010001011100100111010110000000010001
00000000010100011001000101100010000010000100010000100001011100000000000000000000010110101110011111111
01010000000110001111000000001010000110000001010110011011111001000100000001100010100001110000000101010
01010100000000000010110001000010011000000101111100000010100000000011000100010101000000000011011100000
00011000100100000001010000010010001000100001010011000000010110100010000000110000001001100000001001001
11000101101100100110001100110010101011100010000111111100010000100011000000000101010100001000001010000
00100101000100000110011000000000000000000010011000000101111001000000000000000010011000001000001110010
11110000000010010100000001100000010110001110110100001100000101001001000001010000010010000001011100000
00011100100010100000000000111001101010010100101110000101000011010010000011001100000001111000000110001
00000000001000000001100111000000010000010000000001000000000001000110000000000011001000011011000001100