99,74
70,62
10110101110010010100011001000010010010001000101000101100001100100010000101011000100000000111100000110
10000000001000000001110000000001101010000101000000000000010100000001100001010000000000001001101100100
00000011010100110110001100110000010000010100100010000001111000000110100001100110000000000000000111010
01000100000000000110000100101001011001001111100101101010100010010010100000101000001000100001001001010
10000000000101000000001000001000010000000000000101011000010100000101100000010000000000000100000000000
10011010011001111000100000000110001000000101000011100001000000011100000100000001000101101010001000000
00001100100000110010011011001000010000100111100111001101000010000001000000000010010001000100001001010
01000001110010000100001010000010001101100010000100000110000000001000001010000000100001011000000100010
00000110011000000000100000101111101111010001100000101010001000010001011110000100000001100001100100000
01010010100000001000010110000001101000100111000000100000010010010100010000100010010100100100011000110
10111000000000000010000000000010111111010000000110000101110000000100001010010001000101100001101001100
01010000001000010100001001010110010111000000100110001111000010110010001101100000001010100010000000000
10010101100000110010000000010000000001000110001101000000011100010010000110001000000100000000001010000
10001100010010001010010000111100100000001011000011000010000000100010010000000010101000010111100011000
10001000011101110010110100100101010000000000010001000001100000000110001100010110010000011111000000110
00001000110101100000000000110100111010000001000100010000000001001000100100010101010000001011011101100
00010001011000000100000000010000001000111010000101001000010100000111110000000001110010000000110111110
10011110000001100010000100000000000001000001000001111000100100010000000110000000001100000001101010000
01000000000001100000000010010100000000000100101000000001000101000000110011010001101111000001001000010
00011010001001001110100000000100101010011101010010010001001100101000000010100001001000000000010100001
00000000000000010001000100000001100101000100000101000000010000000010000000100010000100100011100100001
00010001000000010010100000011000100011101010001001101000110000000000110010000111000010111010000000011
01000010110001010010010110010000011111001000000000100111010010001100110000100100000001110001011110011
00011100001100000000001000010001110001011000000010010000000101000010000110000100000001011000010000000
10000001110000000111010010111000000001010101001110000100010010100100001101110001001000100000010010110
00000000100000001000000000000000110000100001001010000000100001000000000000101100101000000100000001100
00000110000001000100000000000011101001010000101010101010011000100000010111010000000100110011100111000
01000010010010010101000000001111001000001001100011000100000000000100101000000101100110001000011010100
00101000000011100100000111000000001000001010100000010100011011000000011010100100101000000000010100010
01000001000001000001001010001000010010100100100001110000000010000100000000000000000000011100000000100
10010000000000011000000000011100100100000011011101100010010000100100000010010100001100000010100010000
10101011101110000010000000001000001001110000001100101000010110001110010011100000101010000110100011001
10100101010111101101111000001110000010010000100100111001010000001000010010000000000000111000110000001
00000101000000001001100000100001100100001101000000100010000000000100000100001100100000011010101000011
00000000000011010101011000001101010011100001001001000000000100100010000001010001001000000000000001001
01110010011110000101001001100001000011000000000001100100000011110001000010011000100000001101100000100
11011010001110000000000000010010100000100010000000100010101001101100001000010010110001000010001101000
00000110000000110000000101001001000000000000000100000001100101000100000000110000011110100100010100010
00100001000001000000000011000000000101000100110000001001010001101000100001001001100010110011001001001
01000110000000010100001000100000101101010001000001100000110001101000001000000110100001010100001001100
00101011110000101010101010000010000000000101010010010010100110000000001100001000000001010000100001101
01001001001000100000010010110010000000100000111000000010110100101101000000010110001000010100001000001
00110010001100010000100000110000000101010110100000001010011001001001101001110001000001010000000100000
00000001100010100100011011011100000000000010000010100000010110110000010000010010000100001110001000000
00111000001110100010010000001001100100000001100000000001001100011010101001100100010011011100000010010
00000011100110000011000110000000110101011001100010000011110001000000000111010000010001100001100001010
01000001111001000100011000010110001101000001000000100100010111100101001001101000101011010000010000000
00000011100010100001000000000110011000000000000111000000001110000011000000000101001010001000000010000
01011100011100010010101001010110000010000001100000001010101110000011000000000010001110011000000100010
00000001100000010100110000101001001100000000001000100001101011100110001001001011000000100011000011100
00110001100000010010010001010010000000010011001001010101000010101000100000000100000101000101001001000
00111001100100010010100101100001000000001001001001001001010001001000001100010100001000010001001000010
00000100101001101001010011100100010001100010000100001110010000000000101100001010100000001100001000100
11010001000001000000111100100000110001000000110000101111000011101110011001000000100000001101001100001
00000000000000100101001000101011000111000011110000000000001110100011011000001000010001100001001000000
10000000100010000000010001000000001010100110001100101000110000001000000000000000010100011000100000010
01000101100001000000010010100001011000001000000010000000101010101001100000001100010000000010010010100
01000111000100011000010101011110011000000110000010100000100101100100001010000101000011010101100011000
10110001000011000110010000111001010010001010010010100010010100100000101000000000000100100101000110010
00011001000000010000111011100011100000100000001101001110010010001000100000100000000001010000010100000
00000101101100110000101111000001000000011010000100100101000100010010000001000000100110010000010000100
00000000000010010100000010000100111001011010001101110000010100100001000010001110001011000100100001000
00100100111011100010000110010100000100000101010100011101010000001111110001000010101011001010101011010
10010100110100010010101011011000100100000000000000000000001010000010011110010111000001000001010010000
00010001000000010100000010000101000101100100100100011000000100000100000000100100011001010000101010000
10000000101001001010100000000010111000100000000000001000001010010110000000110000001000000111110100100
01000000000101100101111111110001100001000000010110000011100000100000000001000001100010000101001111101
00000100000000110100000010000000000000000010100001101000000011001000100101011010000001010110000000111
11010001000000100000001000000000100000001000010100000100001000101010001010000101000011000100000000000
00101010100010110010000000100000110011100000011000110000110110000010000101110101110010100000000001000
01011000000000010000110100010000000000010000101000010100010100100000000010011000001110010110010000000
10001001000000100100001011100010010001001010001011000010000000001000000010011101000100011010000010000
01001100100000000000001000000000001010100000011111010100001000011101001010000111100000010000010110001
00000001110000010000000010001000000110100100001110000000100011110100001000001111000110010000110000110
11000011000001010000000000010110011000010000110010000000001010000000010010010101000111010101100101000
10100000000101001000001000000010100000100001000000000100000100100000010101001000001110111101000000000
01000000100000011000010000100010001010010000100100000000100001010011100110010000001100110010101001000
00001000000101000011001011100000000001000000000001000000000010100110000101001000000000111000000001100
00000001000010010000100000000010010010110000010000111001001100111010000100100000010000001100010000101
01100100000000100111000001011000000010000000010101101000100001001000010000001000100110000001000011010
00000000111000000000000000000101010000000100001000010010000000000111000000000000000001110101000000000
10001011011001001000000001000000000000000001110000000000000011110000110001000000000000010011000000000
00000010100011111010100010100001111011001000001001110010110010100101011010100101100010000000100001000
00100110000100100111011001010010010101100001101000000110100000000100100000100100000010000100010000000
01110000001100000000010000100100010000000000000000000010000001010001110001000000000100001101011100101
10000001010010001100010010011100000000000101001100010000011000001001010010000101001001101000001011010
10010000100001000100011000001010001000000011100000110000000000000001100010000000000111000010100010100
00000100110011110000100000000000011100001010000110010000000100011101000000010001000000000001001000000
01000000100001100100100000100010000000011010011100011010100001100000001000100100100000000001010000000
11100000000110000000010000001100010010110000001110000000000010000010011111010001000001010000101110010
00010000101100110111001011000000000000110000001010000001100000011000000000011000101011000101100000100
01010100011100100100010000000110000010100100001101100000000101001000001101111000100000010000110001001
00010010000100000000000010110000000110100000000100100001001000000000100010010000010001000000001110010
00100001001000110100010010001010000001000000001101101010001000010000100000011000000010011010001000100
00101001001000000010010000000000010010010010011000001100101010011011100100001100000100000101001001000
00011000110000101110000001011000101011010010001010100111001010000011000000000110010000010000110100001
10010000001011000111001101000100011000110000000101000000000001111010100100010000101000000000101001010
01001110111001000000000001001000000101010001000100010000001010010000001010100001100000001100100010001
00100110000010010000011100000011000001111000101000001000101110000000000001100000000000010011000010000
00001000010100001110010100100000010000001011001000011001100000001000010000000101101110100000000100100
10000000011001110010000011100000110001100001101010101001110110110000101000100100000100101110101100010