89,58
45,39
10010000111010010000110011000000001001000010000001100001001000000000000000101000100001011011011001010
11000010000000100111001101000010010001000100000011000100010000000100000000000000001011000110100010100
10001010100010001010000000010000001000000000100000011000000000100000010100000010000001000001010000010
00001011001000000100000110000001110001000011100100111110001010010001010000000000110100100000000011000
00010000010010000101000000001011000000100000000000000001000001011000010000011011100001110000110000010
00010000011000011000010000110010010000001010011110000010100000000001011010010010000100001110100101011
01010010011101010101100100001000000000000110010100000101100010000001010000000001000000000110110000010
00000000100001100000000111100100011010000110101000110000001100000001001100010010010000000010000001100
00000001011100000011000000000100001101001001101000000011110000010001110101000010001100001100000101000
00011000000000100101000101000010101010011000000000010110000111010100010001000110000001001000100000000
11011001000010000000001100110001010001000000000000000001001000000101000001000100000000000000010001111
00010100000000110000100100011101000000010000100001000011000111000000100111000101010100000011000000001
01010001010110101010001110001100000010000000000110110001100110100000100001100100000101001010010001001
00000000101101000000101110000001101000000001010010011001010000000101011010000100000110010000000001000
00000100000000100101001000100001110010010000110110101010000101111000100100000100100100001000010111001
10011000111000000100001001000101011000001000000110110110110000110100000011100010010010001000000001000
00101000101000000000010001000010010001000101000101011001000101100000010000110000000100000001100010000
10000100100011011100010100000010011010000000000000000100000001101010000000000000000000000100100110001
01000010000000000110110000001101001100101010001000011001001101010110100010101001101100000010100011001
00001110010000110010000000110001001100110010101011100011000000000110100110010000000010001000100110110
10100000000000001001000000011100000000101000000000010000010000000000001010000000000110001100010000001
00000110100100010010001001100110111001010010110000010111010000011000001100000010000000000001000000000
01101110101010000100000010000100001100000110001000000100000001000000100100001000000001001000101010000
10000000000000000100000100001100100010110011001000000000000010000000010110010001000100011010111001001
00000000000000000010100011010000100000100000001010101001111100001110101000011010100010001001001010000
01010101111011000101000100000111001110001011011000001100000010101000001011100001100001101001011001000
00000000101100010000101101010100111000000001000100010100001101000000100100000000111010100011000110000
11000001000000000100000011001101000000000001010000100000000110101001010000011101001000001010000000000
10010101110110100101011000001000000010010100101000100100001000000011010000000010001100001000000001101
00001000000010000000100010000001000010000010010100010000000010101000000000000010010010001011000010101
00000000101110000000000000010011000110000100100100000000000001100011010001110001011001100000000000000
01000000000111110101010000010100010100010110000100100010110011100100011000100100000000010100100010100
00100100001110000101000110001100000001000001100011010100100001001000010010000100110110110001101010000
11000100100001100101001001000100101000010100001100000001010001000011000000000000011000001000100100000
00000001000001011101110000010001000011000100100100100100100001001101000000100100010010010101101110100
01000000100101000101001101100000101111000110000001001110110001001001001011100010000111000000010001100
01001000111110101100011001000000001010100100000110010000110101100001010010000111100000000100000000110
00000000000011010010000111000000100010100001000000000010000000000010000100010100001000101000001000000
01100110000001001011000100000000000101001100111100110100000100000010000010001010100001110000001000101
00001000110010000100101010000010000101001001010110000000011000010010010000000010010000000010100000000
00010100000101000010001000000000111110001110100000010111000111001000101001000000010000010010000000000
00010100001000010000001100000110000000000000101000000101100010101000001010001000011101110000001001010
10010000000000100011000001110000110000100010001000010000111000000000001010010101011000000011001100011
10100110011000000010111110101100001000110010000100110101000101010100000000101000001000000000001001000
01010000000010010001000100000010000101000001010000100110100000001100100101110110010011100010100000001
01001100000110000000010001100100101010001011010101001000010011011000001000000010000000101110101000100
00000000100001001000001001010001100110000010100011000001100000100010000101000001000000100011001100000
11000100001011011010100001010101000101001001100010110000011000011010001011000010000000001100010000010
00011101000101000000010000100101100111001100100110110100000001011000100100011100100101000000011000000
01100100010100110100010011000010000000110100001001011001001010100000000100001001000010010000100010000
11101000001000100001000010100010100011001010001010001101100001000000000101110000000110000110000011010
00100000011000000001001000000110100000000000001000010010100110000100110000001001101110010110100011100
10001111100000101010000111100100010001001010001001010000001000001000100010010101110101000010101100001
00101111100000000100000100101011000000001000010000010101000000010000100100010000100000011000001010010
10110110000001000000001000110010111000000000110110010001101000100010000001011100001001001000001000011
00000001000001100010001110000000000010000010010000000011110101000000101110000010110000010010001100100
10000010000000000011101110000000000010101000011100000010000101010100000000000010100001000100001100001
11110010010000001000000001001100001100101100000001110011110000001110000010011100000100000010000001100
00001010111110010000110010000001000000110010101011010010101000000001101011001000100000010000110100100
11001000000111111001101001010100000000000100100011010100101100000001101000011111000000101011100001000
00000000000011110011110010000011001000010001011010100100110001000111000000110101100101101001111000110
00000001011000100100000100000000000001001100101011000000100001010100000110001001000000100000111000010
00000101000001001111000011100000001010000000110010001010111000010001000100101001100011000111010000100
10000000010001101010110000100001011110100011100101101000010100000000001010100001001000000100000100000
00000100000000110011000001110011101000111011101100000001101000000010111110000100110010110000001000000
01010000000000100100000000000101000011101000110001000001000010000000000000110000010100000000100100100
10000001001000000010110000001111110010101110001100000010100000000010001010100100000010110010100011001
01001100111010011001010100100100100110011000011000111110000000001000110000101000001101000100001010010
10000111100000001010010000000000100111011000100110001110101010000000001001100011000000011000011000001
00000001100000100000000100100101101100000001000000111100111000100100000000010001000010011000000101001
00010001000010100100110000010110000100011000000001001001100001010000010010000000010000100011011111110
10010000000011011110101000000000000111110000001110010100000000001010001000010111000000001110100010001
00001111011010101000100101001010100110000000000000011011100010011000001000011100000000001100100000111
10000010001001000011000000011001100100010000000000000100100000000000011000110101000000000000100000000
00010101001000110101000100001000001101000000000011000000001000001111010000010000000010001100111001011
00001000011010010100100010000000000111000001000000001000001001000100010101100010001110001100100000010
01000001101010100000101011010001110000011000101000100000001001010000000000011010000001010010000101000
00000000100001100010001100000100001001001000101000001100000111110111011100001011011101000000100001100
10010000000000111100110000110000010010101001001000000110000001010000000000011100000010010000010001001
00101000000000001000110110010000100111100001010000000110000100100001000000100010011100000100001001001
00100010100101010000000100000101101101010000000000100001010000000000000000000110001001101001101100100
00000000010010001101000010100110010000100000011010001100010010000010010010000000000000001100000000000
00100001011000101000010000101000000011000001000100100000010010100000010111000100101000000010000110001
00001100101010100011101000011100011001000010100001000011110000000001110000001000010001000000010100000
01000101011101001110011010010111011100001010010011000010010010100000000000000010000110001001000000100
00010100010000110001000000001100000010101011101010010000000100010011100010110111001010111011000011000
00011110011001000000011100011000000100000000101111010010000000100011100100000100100001000000100011011
00010111010001101011000001101100011010000110010000000000000000011001000010010111000100011100111000011
10011010000100010000100001000011001100011011000010110000100010111100010001000100000000000010010100010
00100000110001000010000000000000000000010100101010001100000001100000100010000011001011010000011110110
00000000001001000011101010101001011010000010110000100110110011100010010000101010010000000010010110000
10100100000011000101100011001111001000010100010010101110110101000101100000101010000100100010101000100
11000100101100000000010001000100100110010000101000001100001110101000010000000100001011001000001010000
01100000000000101000010101000000000111000000000010100011100100100110010110110100000000000010001000000
11001000000001000001100000100000100000010101001000001010000010110000011111000010001000000001001000000
00110010101000110001000000100010001000001100100001100100101010011011000000010100000001110000110010101
10000000100110010000010000100110111010000000100010000001000100110100010100100000100101101000000000000
00110010100000011000000110101000000100110000010010010100000000101000000001101000001100110000000001000
00000110000000010000101001000000000100100000000000000000001011101110000000000000000000000010100100000
00000000110110100000010101001010000000010000010111110010010000101110100000010000010001000000000010001
00000000101011000001000000010010010000011000000001100000000000010100011000101001000000000100110010000