45,12
14,8
10011000100101101011011010100000011000000000101100000101110000000010110011010000011000010101001001000
00001000100001001000111010000100100010000001000011001101000101101100000001000000110011100001000000101
00000101011000000001000110000000101101100000110000010000100000000100011110000001011001111100110000100
01100001111001000011100110010000110001010010000010001101011000000101001010100101100000001110000101000
01000010010000010010010000100010000110010000000000001000100000100001100100000001111100000001100000100
00010101101111000100100000000000110000010011100000000001011001001000100000010000100111000100000011000
00000001100010000001010000000010010000011110010110110001101000000100101100101101101000100000000000010
00000100000100110101000000011011010000000000000000010011011000001001000011100111101001100001100011011
00100101100000000001000010101000000000100110101001000000111000011001000000100111000010000010010000010
00001001111101100001000010000011111100001010001100001000101000001101100000001100100101000000001000011
00111010001110101110000110000100000001101011000000001001000110000001000001000110100000100001001001101
10000100001011110001010001001001000000000100010010100000000101011000011000100111100000010011000000000
10010110111110101001000000000001001010000101101000010001010011001001100110010011010000010011111000000
00000100011100000010110100010101000101011011001001111010101110000110010011110000100100110010001000000
00100110000000001101010001010000000000001110010110100110100000000010101001000010110000101100100000000
01000001100100100000101000100111100000011001000000010111110110100001000000010011000000011011001000110
00010000010001000001010001001100000001000100000110011000100000000100110010011100010000000000010010000
01010011110000000000000001000100010010000010010001000011110101000001000100101010000011010000000100000
11111101001000000010000000101010100010000100100000110001000000010100101111101000000000100100011000000
00000000001100000100000001110001000101001000110001100000010001001001000011011000000010101000000010001
01000001110001101010000000010110011000000001000000011100001110001100001000000001000001000110000010011
00000110100001000011100101000100010001100000010000010100000000010010010000111011001100000001010000000
10000010010000000101000100100100000000001010000010010000010001010010001100110000001001000010000000010
00010110000010110000001010011111000100010010010010100000100001000000010000101000010001010000000000001
10000001001000010100000100000101000010101001010000000000001000101001010000010000000000001000100001010
00010001000100100010010101100110000000100100010010000101000001000011001010100010100100100010001000011
00011000000001101000011000000101000110000000101001000101001100101000000001011000110000000110001100011
10100000000011000000100000001000000100000001001010010101110011100100001010001000100001010100001001011
10001100010001001010001011010000010110001001000110101011001100000001100000001000010011001001000001001
00010100100010010000000000010011001000001000001100100000001110010100010000101100010000001000000000110
10000000011000010001010000111100000000011000001000010010010010100010010100000000011110000110100000101
11110111010010000000011010001101000000010001010000011011001000000000000000001001001010010010100000010
00000111000000001100010100000110011000010011110010000011001000000100001001010001010000100010100001010
00100000010101001001010000110100000010010000000000010000001000001000000100001111000000111000101000101
10000000110001010100000001000000000000000010100010011000001100100001101001110011010011100100100001101
00010010010000100111100000010000101000010001010000100001010110000000001100001010001000001100000011010
00010010000000010001100101000000110000100000000000000001100100011000011101000011000001000000000110100
00000001000010100000100001000110000000011000000001011100101010110010000000010001010100001100000010100
10101011000010011011010100110101000110000010000000101010000100011000100000110000011000000000100000000
00100001100000000000010100001010011000010010010010100001000000011010101000101000000010100000001100010
00101000000000000010101001000001110010000100100010000001010101000111000000011110010000011000110010001
01000100100010100000000001010001000100000100100000110001000010100011000100100010100101100000010010011
01000100110010010011010000000000000010000001000100101001101000000000000110001000000010001100000111000
11001100010000110111110011100100111101100011110000001011010000000101000000001100000010100000000000000
01000100100000000000010000001111000000000000001000000011010000000000111011100010010000000010010000000
00110010000000000000000001101000110000000000100000000100000110110000001001000010000110100001000001010
11000100000011000001110001000010000001100011001101001001000000001101010100101000000000000010101000010
10000110100000010100101010000110010001101001100010001000100001110000000010000100010101111001001001101
11001001101010011000111000000000000010100010000001001000001001101001000000000110110110011000100100001
10101011000100100000100000011000000000100001001110011000000100001010110001000010000000101100100010010
00000101001000000000001000010101000010101000100000000101000100000001100100110000011010011010010110000
01000001101000110000100100000010010000001010000011100000010110110000110000000100011100010000110001000
10000100011011011000000000010100001011100000110100000100010110010010010000000001001000000100000010011
00010000100000000100100101100010000001100001001100000000011001000010000101001010100010010110011000110
00011000100000000111011101100100011001000101000000010001011011010001001001000000000110000001000000010
11000000001010100100100101000011000001100100000110000000000100000111000000111101000100000000000110101
00101010001000100000001010000100100001001000000000010010000011010000010001000101000000000100000101100
01000100000100010001000101000001011001000100000101001000101000100001000100010000100001110100010000011
00000100000001110100000101000011000011000110010000011001001010001000001110000000111100100100000000001
10110100010010000010000001000100100010101001011010000001001000011001000010011100100000100000101000001
01110010000001001011100000000000100001000100010001100000001110100100000100001000001101000000100110001
00100010000011101010110100110100101001011101101000000101101110111000100000000101000001010000010000000
00000001010000000001100000010000001001101001001010110000011000000001000100000101101000110000011000100
01010000010010001000000001100000001000000001011010100000101000000000000001010011111000010000100000101
00000110100100001000111000000010000000011110000010000000100100000100011110010100000000000100010000110
01000010100110001011000000000000010001010010011000111000001001011000000100110010010000011010101010001
00110110000010000100000000001000000011000011000111010001010010100100001000010100100011100000011100000
00111000100000001000001110000101100100010100000111101000111000100001010110001001000000101010011001111
01000100110001101100000100011000000101001010011000001110110001000011000110011011110000000000010100000
00110011010000100000011000000001100000000100000000000100010000001000001011001001001101100001001001000
00001010000110101010001000110000100000100010001000000011110101101000110010100000100000001100000000000
00010111000010100000101011010010100110010100001001101000000010000100001000000100010000000101001011000
01101001000000001000010000101000001001110000001000000000000101000011100000010010000001010111100000000
00000001001000101001100101101010010000010000000000011101001010001000000110000010101100000110000100111
00100010000000001100010000110000110100110110011001101000001000001011111000001000100100100010010000010
10100011001000100010000100101001000001010100001110100101101111001001001000001000001010100110000000000
01000110000100100000110000001100101110000010000010001000010000111000000010000110010000000001000100000
00100000011011000100000001010001110001111110011010100100010100101000100000101001010010000010110111101
00010100000000101000001110000011000001000000111001010000000000110101101010101000100000000111001101000
10100101101010010000100000010100100110001101110000100100010101001100110011010000001011010100010010100
00101001001001010011101100001100100000101000001101011000010010011100010110000000010000010110001001000
10000000000000011100010110011010011000000000000110000000100100001101011001010000000111000011000010100
11000100001100101011011001010001000000100000101000010001010100110000000000000000001000100111000000000
00110010101000100110000001000001000011010000011000000101000100010011000000010111000000100110000000000
10010100000010000010010000001010110010010010000000010000010000110001100001000100010000011100010011110
00010110000111000000000111001010011000100101010100111011100100001011101011010001000001000000010000001
00011101001110100000001000000010001100010010001101000000101110000000110001000000100011000011010010011
11100000001110100001100000100011011100101010001100000011000100100000100000000101000101010010000101010
00000110000001000000001000110100010101001100000011001010010000000000010010000000010000010101000000100
01000100000000001011000011000100100001001100101000010100011000111000100000011000000111000010001001101
01100111001000000100000110010101010000001001011000100000000001010001110100100011000000000000010001110
00001110110000111000001000100010000110000000010000000010010000000001000010010110100000110000101000010
10000000000000001000000001001000001010011011100101001010001110010000100010000001010001000000000100000
10001000100100000100000100100000100000000001000101100010001000101111000000000000100000011011000110100
11100100001000010001011000010100101000010011000011001000100000011101000100000000000100010010010001000
01101011011001000101000000100101000000100000001000001100000000101000000001011101010001000010000000000
10110010001001001000001000100010110001100010000001001000011100101011010000100111001100010000010011110
00000100100000111000010001101111010100010100010000000101000001101010100100010110010000111011000000110
10001100100010000100000111000010001001000010010000101100110010100000101000100101000000010000010010001
11000010100000111000000110010000001000101100000100001000011010000000100011010100111010110111000111101
01001000001010111010000000000000100100101000110111000000010100011001001001101111100000111000000110000